State,District,Latitude,Longitude,District Code,Population,Male,Female,Literate,Male Literate,Female Literate,Hindus,Muslims,Christians,Sikhs,Buddhists,Jains,Others Religions,Religion Not Stated,Households,Below Primary Education,Primary Education,Middle Education,Secondary Education,Higher Education,Graduate Education,Other Education,Literate Education,Illiterate Education,Total Education,Age Group 0 29,Age Group 30 49,Age Group 50,Age Not Stated,Total Power Parity,Sex Ratio,Literacy Rate
Andhra Pradesh,Adilabad,19.284513950073435,78.81321233480176,532,2741239,1369597,1371642,1483347,856350,626997,2399901,275970,15422,1377,25510,617,322,22120,817714,232470,344167,281752,225957,143143,100226,19277,1346992,1030640,2377632,1536378,704551,422522,77788,4181,100,54
Andhra Pradesh,Anantapur,14.312065561843148,77.4601584478577,553,4081148,2064495,2016653,2310960,1338474,972486,3599372,443456,20463,932,341,1417,309,14858,1244428,462273,720357,582075,331793,162175,144915,23341,2426929,1369069,3795998,2189396,1104565,739612,47575,5799,97,56
Andhra Pradesh,Chittoor,13.33109263067696,78.92763898886037,554,4174064,2090204,2083860,2667878,1484794,1183084,3737588,397870,24129,867,253,1322,358,11677,1303870,522961,770836,673197,548336,265199,246409,36017,3062955,1170993,4233948,2148179,1159053,807430,59402,5926,99,63
Andhra Pradesh,East Godavari,16.782718320784902,82.2432074720511,545,5154296,2569688,2584608,3288577,1716933,1571644,4983330,77777,77825,738,413,4149,403,9661,1605841,669420,947606,797497,521562,271809,263023,47702,3518619,1524603,5043222,2724328,1478954,948122,2892,7211,100,63
Andhra Pradesh,Guntur,15.884925767634847,80.58657614107885,548,4887813,2440521,2447292,2960441,1634726,1325715,4217597,559770,89763,764,323,3282,332,15982,1582990,736270,845810,674957,453446,246580,221924,30279,3209266,1474349,4683615,2583462,1371811,928462,4078,6981,100,60
Andhra Pradesh,Hyderabad,17.38971555555556,78.46668888888888,536,3943323,2018575,1924748,2892155,1542688,1349467,2046051,1713405,87522,11446,1268,19560,1929,62142,1066289,230962,596591,685215,811501,517425,558090,45937,3445721,556902,4002623,2249130,1068243,542669,83281,11071,95,73
Andhra Pradesh,Karimnagar,18.515483193277312,79.43765428571413,534,3776269,1880800,1895469,2206829,1257238,949591,3491139,244723,24979,2086,332,312,115,12583,1165280,340372,453505,482842,463403,293493,256633,35312,2325560,1280393,3605953,1940234,1031735,728494,75806,5251,100,58
Andhra Pradesh,Khammam,17.683921325051784,80.67008643892335,541,2797370,1390988,1406382,1630234,901640,728594,2595321,158887,33463,655,217,459,539,7829,870625,295639,346118,329630,238811,154774,160804,25456,1551232,875272,2426504,1530602,774583,477955,14230,3836,101,58
Andhra Pradesh,Krishna,16.143872753151673,81.14805061000413,547,4517398,2267375,2250023,3009718,1598959,1410759,4023678,307043,145598,1393,863,6320,906,31597,1476334,618101,692968,630603,531821,312753,328454,54728,3169428,1352499,4521927,2340943,1284630,833959,57866,6983,99,66
Andhra Pradesh,Kurnool,15.43759715142429,77.90086836581717,552,4053463,2039227,2014236,2127161,1246369,880792,3328380,670737,33165,737,255,2235,434,17520,1090835,521327,672951,466940,271828,152453,115504,19282,2220285,1517933,3738218,2368684,1053618,609027,22134,5301,98,52
Andhra Pradesh,Mahbubnagar,16.639546224256293,77.98933089244859,538,4053028,2050386,2002642,1940646,1158386,782260,3673456,334172,21345,658,290,388,267,22452,1010015,419379,596134,441585,308575,169083,98227,16121,2049104,1604319,3653423,2360874,1027525,637430,27199,4695,97,47
Andhra Pradesh,Medak,17.889304978038055,78.13778901903379,535,3033288,1523030,1510258,1637137,953406,683731,2637313,342449,34301,1309,554,457,217,16688,789132,324267,503713,481984,373729,201928,127493,16466,2029580,1199818,3229398,1735769,779738,509368,8413,3874,99,53
Andhra Pradesh,Nalgonda,17.113250515463907,79.16984453608244,539,3488809,1759772,1729037,2001019,1160757,840262,3249231,188646,35025,937,241,250,132,14347,1030937,369537,518669,471233,367424,238695,196134,27003,2188695,1294811,3483506,1932349,897137,651748,7575,4468,98,57
Andhra Pradesh,Nizamabad,18.429485849056604,78.07523490566035,533,2551335,1250641,1300694,1389810,790214,599596,2123426,391596,19653,2357,1847,542,146,11768,720298,269487,421399,338668,396396,223365,141850,13382,1804547,1041862,2846409,1399773,676401,437573,37588,3458,104,54
Andhra Pradesh,Prakasam,15.489039001601704,80.11665790176184,549,3397448,1714764,1682684,1904435,1107686,796749,3150195,220654,18775,266,97,204,206,7051,1087575,489805,495556,368919,249034,142026,133627,21976,1900943,1218310,3119253,1832695,917391,641707,5655,4304,98,56
Andhra Pradesh,Srikakulam,18.570900998697432,84.25874814010675,542,2703114,1341738,1361376,1495381,857824,637557,2666950,9025,18879,193,77,160,106,7724,902436,291793,348354,319244,251521,146721,121213,21031,1499877,1009992,2509869,1423119,747385,528736,3874,3301,101,55
Andhra Pradesh,Vizianagaram,18.28329696032972,83.45982854198873,543,2344474,1161477,1182997,1238388,707503,530885,2299129,16423,17853,380,114,815,183,9577,749514,250446,300057,257468,186576,115144,103591,27041,1240323,1031683,2272006,1206366,666394,451469,20245,3103,101,52
Andhra Pradesh,Warangal,18.01752608695651,79.87422028985509,540,3512576,1759281,1753295,2065023,1179790,885233,3273755,197333,31377,1453,253,569,126,7710,1046987,314252,457529,454322,430242,279234,248942,27663,2212184,1191252,3403436,1891954,941452,664872,14298,4762,99,58
Andhra Pradesh,West Godavari,16.63297943925236,81.45912990654196,546,3936966,1964918,1972048,2652389,1379223,1273166,3733191,86142,109120,288,209,1578,211,6227,1255628,595331,718960,585595,415178,215863,207586,33329,2771842,1028767,3800609,2051513,1127764,755533,2156,5485,100,67
Arunachal Pradesh,Changlang,27.36048479338845,96.37552644628106,253,148226,76948,71278,73174,44027,29147,47683,2134,35969,94,50381,95,11738,132,39920,20425,22537,17354,10032,5641,3633,834,80456,57290,137746,96630,35018,16414,164,348,92,49
Arunachal Pradesh,East Kameng,27.371194055944056,93.04741486013997,247,78690,38775,39915,38449,21599,16850,12333,652,37136,36,452,23,27868,190,19718,11713,10487,8852,6213,4510,2330,142,44247,31763,76010,53752,17922,6960,56,348,102,48
Arunachal Pradesh,East Siang,28.15382352941176,95.06499226006191,251,99214,50116,49098,62576,34210,28366,27854,2289,18254,69,776,30,49393,549,29021,9938,13713,13968,10937,9498,6540,525,65119,21543,86662,61993,25334,11802,85,644,97,63
Arunachal Pradesh,Kurung Kumey,28.04853351800553,93.24531994459834,256,92076,45318,46758,36606,20258,16348,4859,471,51189,43,121,81,34158,1154,19695,12661,15054,12264,6997,4353,2031,299,53659,42621,96280,64379,20713,6836,148,348,103,39
Arunachal Pradesh,Lohit,27.946785273972623,96.59670770547945,259,145726,76221,69505,83062,48380,34682,99020,3846,10684,210,24452,104,7277,133,44971,19306,25179,20643,13070,7612,5180,584,91574,52421,143995,94890,35493,15195,148,348,91,56
Arunachal Pradesh,Lower Dibang Valley,28.32651730103806,95.76567335640142,258,54080,28053,26027,31849,18087,13762,28915,2247,9213,33,2932,19,10393,328,15950,5875,7957,7351,5508,3570,2795,85,33141,14406,47547,35140,13254,5652,34,348,92,58
Arunachal Pradesh,Lower Subansiri,27.70849297297297,93.96226108108112,255,83030,41843,41187,54057,29470,24587,9551,1482,34402,27,193,13,37085,277,23477,8492,10821,11661,9861,7674,5230,295,54034,17273,71307,55258,20305,7412,55,348,98,65
Arunachal Pradesh,Papum Pare,27.273529716981127,93.54468183962264,248,176573,89182,87391,121048,65794,55254,57027,6148,84397,310,4768,139,22586,1198,50488,15368,21956,21376,20007,17342,13840,926,110815,30360,141175,120592,43812,11856,313,644,97,68
Arunachal Pradesh,Tawang,27.680683962264148,91.82504245283016,245,49977,29151,20826,26073,17720,8353,11842,787,776,1164,34920,72,349,67,13182,4904,4730,4029,2140,1989,1379,667,19838,19203,39041,30709,13849,5399,20,348,71,52
Arunachal Pradesh,Tirap,26.94406229508198,95.41470327868862,254,111975,57604,54371,47974,29313,18661,20682,1103,83361,61,778,43,5325,622,24920,13585,16989,12077,7834,4305,2134,182,57106,50628,107734,71785,25669,14423,98,348,94,42
Arunachal Pradesh,Upper Siang,28.8309244897959,95.00155765306124,252,35320,18699,16621,18195,10723,7472,5261,411,5643,27,2577,7,20967,427,10751,3952,5584,4915,2935,2211,1349,46,20992,11209,32201,21090,8910,5252,68,348,88,51
Arunachal Pradesh,Upper Subansiri,28.277196566523585,93.8991435622318,249,83448,41758,41690,45278,24807,20471,13474,521,8779,28,297,11,59449,889,19214,10219,16118,15339,10348,8017,4276,473,64790,28364,93154,56054,20055,7230,109,348,99,54
Arunachal Pradesh,West Kameng,27.46486582278483,92.65015750452083,246,83947,46155,37792,48492,29566,18926,31265,1970,8466,328,36087,71,5556,204,24195,8836,10317,8428,5633,3987,2693,299,40193,25606,65799,53026,22362,8493,66,348,81,57
Arunachal Pradesh,West Siang,28.106296920289843,94.53510344202908,250,112274,58168,54106,64746,36777,27969,15881,2218,29969,577,3311,49,60005,264,30775,14227,17675,15908,11441,8418,6030,521,74220,27956,102176,70415,28305,13469,85,348,93,57
Assam,Barpeta,26.427872264631056,90.97912010178116,303,1693622,867004,826618,897058,499038,398020,492966,1198036,1020,112,49,399,14,1026,499381,210607,307884,300845,121924,87377,46947,8007,1083591,664161,1747752,1072312,405046,215355,909,348,95,52
Assam,Bongaigaon,26.45012521994133,90.6734296187684,319,738804,375818,362986,434078,237114,196964,359145,371033,5924,384,236,871,9,1202,220393,93591,138294,133643,55924,35491,20221,2267,479431,260721,740152,458796,184849,94939,220,348,96,58
Assam,Cachar,24.815570668693017,92.86849650455927,316,1736617,886284,850333,1174128,639946,534182,1038985,654816,37635,280,341,1673,98,2789,435160,256855,447993,379469,156156,79766,45341,12951,1378531,357907,1736438,1048990,444899,241776,952,348,95,67
Assam,Darrang,26.58463215962442,92.04141338028155,325,928500,475273,453227,487039,268666,218373,327322,597392,1688,431,57,724,19,867,288706,119027,163277,161153,59039,47398,22267,3079,575240,375556,950796,583436,226525,118102,437,348,95,52
Assam,Dhemaji,27.586533438485816,94.71336908517353,308,686133,351249,334884,423028,237761,185267,655052,13475,8711,297,911,167,6315,1205,228262,79107,138838,136371,80804,55399,28006,2868,521393,194984,716377,434221,169630,82051,231,348,95,61
Assam,Dibrugarh,27.30612284482757,95.0998282327587,310,1326335,676434,649901,884531,491361,393170,1198401,64526,52968,2261,4673,1055,46,2405,377015,143189,243607,301287,139813,89500,59380,6984,983760,340744,1324504,767147,371864,186774,550,348,96,66
Assam,Goalpara,26.017277777777807,90.59869891598912,302,1008183,513292,494891,563577,304302,259275,347878,579929,77862,771,194,477,103,969,268114,124700,213510,183904,73683,39885,18294,3464,657440,375071,1032511,650509,239831,117427,416,348,96,55
Assam,Golaghat,26.377219709794485,93.82583397823468,313,1066888,543161,523727,721764,396475,325289,917426,90312,50582,1131,3863,530,1347,1697,327083,117393,223902,261192,111145,66197,36887,4084,820800,258897,1079697,629153,289085,148244,406,348,96,67
Assam,Hailakandi,24.457496089385486,92.59154664804475,318,659296,337890,321406,407366,226836,180530,251194,397653,8480,84,490,247,636,512,175417,88596,177984,139029,50056,28504,11608,4265,500042,173306,673348,419921,156243,82841,291,348,95,61
Assam,Jorhat,26.76244824016563,94.30197722567289,312,1092256,556805,535451,794929,432335,362594,1008219,54684,21051,1540,2378,719,578,3087,367154,99454,201680,295444,128050,97025,62608,8433,892694,209170,1101864,604908,315550,171062,736,348,96,72
Assam,Kamrup,26.170939452054807,91.58863273972592,321,1517542,778461,739081,995319,550219,445100,877495,601784,33297,319,185,1330,55,3077,434445,163849,290097,353861,154831,118849,55011,6444,1142942,392678,1535620,895775,408232,212740,795,348,94,65
Assam,Karbi Anglong,26.08966454598031,93.11536570271832,314,956313,490167,466146,557214,314253,242961,766000,20290,157789,370,6260,397,3568,1639,252876,109324,212224,199289,93137,40602,18225,3426,676227,310093,986320,618633,233739,103123,818,348,95,58
Assam,Karimganj,24.69660712250711,92.3679498575498,317,1228686,625864,602822,795297,435942,359355,521962,692489,11990,114,446,524,110,1051,294640,198059,333885,257931,76685,39637,21408,7903,935508,303785,1239293,779850,284368,163990,478,348,96,64
Assam,Kokrajhar,26.497246635730868,90.13997470997688,300,887142,452905,434237,489305,275220,214085,529068,252271,101091,93,1718,396,123,2382,222011,116899,166013,154715,78788,39571,17287,2733,576006,340601,916607,552671,224715,108956,800,348,95,55
Assam,Lakhimpur,27.14128805970149,94.0775949253732,307,1042137,529674,512463,683486,375552,307934,797130,193476,46217,412,1074,250,2410,1168,327933,126950,212080,217497,107326,82885,44212,4731,795681,275677,1071358,639385,268872,133615,265,348,96,65
Assam,Nagaon,26.26462170626351,92.9306191144708,305,2823768,1439112,1384656,1710716,921850,788866,1225246,1563203,26844,3036,1073,1162,61,3143,799185,392616,638088,576214,199792,115864,66994,10351,1999919,873197,2873116,1778277,678034,366112,1345,348,96,60
Assam,Nalbari,26.46323767605632,91.40598521126763,323,771639,396006,375633,531771,293184,238587,491582,277488,429,62,27,1004,9,1038,238944,75866,141690,192771,81507,71734,39368,3693,606629,188960,795589,442061,211320,117809,449,348,94,68
Assam,Sonitpur,26.73514926829268,92.85197804878044,306,1924110,983904,940206,1108572,620525,488047,1422824,350536,138166,1363,5088,1003,221,4909,547853,216097,416218,377653,141373,90385,49901,6412,1298039,627141,1925180,1159991,501239,261648,1232,348,95,57
Assam,Tinsukia,27.53549291139241,95.69055949367085,309,1327929,680231,647698,798322,453449,344873,1181347,48373,76877,1999,16228,837,395,1873,381614,150893,266717,276292,109805,61040,38152,7353,910252,417081,1327333,799874,352158,175377,520,348,95,60
Bihar,Araria,26.211528119180603,87.30766554934816,209,2811569,1463333,1348236,1195768,727643,468125,1593525,1207442,4116,371,187,1910,63,3955,703274,625357,426625,206161,112955,68177,39627,6938,1485840,1653766,3139606,1872943,612012,324091,2523,2035,92,42
Bihar,Aurangabad,24.774291867469877,84.45986024096379,235,2540073,1318684,1221389,1466002,868733,597269,2291133,237353,2218,295,334,775,19,7946,477297,559512,482199,302662,253142,136783,91371,8329,1833998,784131,2618129,1626969,564571,340948,7585,2215,92,57
Bihar,Aurangabad,24.774291867469877,84.45986024096379,515,3701282,1924469,1776813,2503837,1430936,1072901,2545438,786677,15991,5142,309093,30981,1005,6955,979132,381695,686271,422964,537936,310762,253253,19101,2611982,819734,3431716,2211996,909771,571932,7583,8119,92,67
Bihar,Banka,24.832355642023337,86.8664916342413,225,2034763,1067140,967623,965321,590961,374360,1772655,250925,6138,139,113,94,1035,3664,444096,408188,386707,196305,120653,63103,35767,3922,1214645,879831,2094476,1291235,462080,278863,2585,1738,90,47
Bihar,Begusarai,25.54302613168723,86.12560144032932,222,2970541,1567660,1402881,1548673,918507,630166,2554330,407348,2209,402,229,276,57,5690,733625,577601,484502,291877,207136,144783,101836,14599,1822334,1242551,3064885,1951688,644874,369996,3983,2354,89,52
Bihar,Bhagalpur,25.277192885375477,87.04213814229242,224,3037766,1615663,1422103,1573066,937669,635397,2487866,537098,3556,415,180,1050,32,7569,653161,614644,524322,300767,247079,154643,118843,16119,1976417,1139715,3116132,1952879,674660,397654,12573,2814,88,51
Bihar,Bhojpur,25.50666439393939,84.49407803030304,231,2728407,1430380,1298027,1599151,973486,625665,2518216,197819,2165,544,647,1472,48,7496,511927,581580,605307,367059,313509,163303,131137,10630,2172525,1005140,3177665,1722387,613072,387389,5559,2600,90,58
Bihar,Buxar,25.48593018867924,84.08808081760995,232,1706352,887977,818375,989807,593544,396263,1591454,105423,2125,248,5090,97,57,1858,334657,331675,420187,256124,178044,89306,64117,5224,1344677,457814,1802491,1074754,375372,253998,2228,1556,92,58
Bihar,Darbhanga,26.146187719298258,85.97387352472099,215,3937385,2059949,1877436,1816634,1125566,691068,3042729,881476,3534,832,245,236,101,8232,1002713,672797,490534,332382,224622,152540,129597,26073,2028545,2203198,4231743,2535344,865971,529314,6756,3514,91,46
Bihar,Gaya,24.7266541547278,84.94291217765044,236,4391418,2266566,2124852,2297613,1368803,928810,3876395,488121,3943,913,870,1723,108,19345,807571,902272,757690,447480,342254,191824,131163,12047,2784730,1953368,4738098,2810026,936630,537333,107429,3998,93,52
Bihar,Gopalganj,26.44874364161851,84.34636127167629,217,2562012,1267666,1294346,1382998,793905,589093,2119262,436057,2463,271,167,133,28,3631,554058,540603,470828,291624,223776,123249,79109,7690,1736879,977719,2714598,1642807,546202,370662,2341,2370,102,53
Bihar,Jamui,24.78418380462726,86.26316298200514,238,1760405,916064,844341,858588,534385,324203,1525746,217621,8443,162,159,87,3438,4749,356760,420472,317612,153973,104211,56137,29633,3439,1085477,765297,1850774,1135919,392052,227016,5418,1516,92,48
Bihar,Jehanabad,25.155679045643165,84.9208124481328,239,1125313,585582,539731,618881,374412,244469,1045117,75742,691,148,248,60,58,3249,214792,211761,165906,117558,112966,68748,45519,3539,725997,495877,1221874,714244,254582,155106,1381,960,92,54
Bihar,Katihar,25.56565356037151,87.70466083591326,212,3071029,1600430,1470599,1280190,762256,517934,1684589,1365645,8659,2754,212,507,2141,6522,738070,472616,444260,237243,133811,88498,57114,11896,1445438,1705551,3150989,2054202,660403,353483,2941,2516,91,41
Bihar,Khagaria,25.53558891454964,86.56593256351037,223,1666886,883786,783100,768028,461153,306875,1486989,175588,1253,143,79,86,115,2633,394703,350601,233494,130004,100555,65931,38697,5969,925251,903323,1828574,1114645,355531,195796,914,1254,88,46
Bihar,Kishanganj,26.324336758321294,87.95045007235886,210,1690400,866970,823430,745056,439921,305135,531236,1149095,5783,398,183,1476,28,2201,445150,356401,235779,89025,42778,25989,15386,3761,769119,945397,1714516,1139615,361114,188447,1224,1347,94,44
Bihar,Lakhisarai,25.183449321266963,86.12825701357468,227,1000912,526345,474567,507270,305182,202088,956396,40886,487,140,52,78,52,2821,207645,172076,149312,111684,85807,48001,27261,3814,597955,450967,1048922,650642,218840,130655,775,904,90,50
Bihar,Madhepura,25.77341929460581,86.8978443983403,213,2001762,1047559,954203,834577,517666,316911,1753829,241760,1342,170,60,133,81,4387,510278,340813,189431,114474,99437,79891,44955,6509,875510,1202278,2077788,1311771,444235,242382,3374,1494,91,41
Bihar,Madhubani,26.41380538172716,86.16328360450552,207,4487379,2329313,2158066,2155338,1340085,815253,3652168,818912,3262,564,328,442,169,11534,1088786,783888,771417,520875,303114,170563,137780,11352,2698989,2003079,4702068,2860455,1009424,611899,5601,3520,92,48
Bihar,Munger,25.198537962962963,86.54173672839504,226,1367765,729041,638724,801817,473741,328076,1252319,110416,1815,338,95,145,61,2576,308063,226699,158699,146414,147152,101907,64469,4394,849734,498676,1348410,860147,316713,188319,2586,1424,87,58
Bihar,Muzaffarpur,26.18664417177915,85.32745092024543,216,4801062,2527497,2273565,2509232,1487117,1022115,4032773,745546,5149,933,288,382,98,15893,1119394,1092952,743623,419433,299475,194920,138916,14475,2903794,1924438,4828232,3016735,1079189,697108,8030,4105,89,52
Bihar,Nalanda,25.229345508982053,85.48053113772461,229,2877653,1497060,1380593,1519933,919558,600375,2669775,198033,1978,393,414,561,64,6435,616663,581978,486266,320839,274556,177358,133032,11159,1985188,1324385,3309573,1829128,642197,403129,3199,2578,92,52
Bihar,Nawada,24.825708836206903,85.61594568965519,237,2219146,1144668,1074478,1091012,659474,431538,1964620,244394,1299,250,176,279,80,8048,424874,601011,368649,195072,161127,95943,64585,3130,1489517,1091439,2580956,1440781,485628,288805,3932,1924,93,49
Bihar,Pashchim Champaran,27.16064352201258,84.30265911949685,203,3935042,2061110,1873932,1759481,1091226,668255,3047427,865090,8469,926,1337,296,1895,9602,936134,1053481,543965,250243,159563,98732,70669,6035,2182688,1710878,3893566,2544205,888205,497793,4839,3181,90,44
Bihar,Patna,25.40297114503818,85.3198433587787,230,5838465,3078512,2759953,3459679,2028047,1431632,5356075,439952,12551,4803,1062,2151,203,21668,1210094,1244842,1095655,920051,698351,463361,452340,46126,4920726,2590473,7511199,3626564,1382654,815638,13609,7065,89,59
Bihar,Purba Champaran,26.68129336734693,85.00382155612242,204,5099371,2681209,2418162,2276957,1407603,869354,4086453,990349,4865,668,878,464,104,15590,1243825,1280809,982506,450631,241118,121594,68781,5149,3150588,2142757,5293345,3316422,1122340,648009,12600,4098,90,44
Bihar,Purnia,25.81714801901739,87.40447606973065,211,3264619,1699370,1565249,1332326,805261,527065,1989420,1255641,7989,614,353,1450,650,8502,798596,668690,360243,184327,119259,83226,59996,11116,1486857,1798786,3285643,2155512,696556,372692,39859,2641,92,40
Bihar,Rohtas,24.99170460829495,83.9350762672811,234,2959918,1543546,1416372,1799832,1061783,738049,2645415,300487,2889,2569,1584,252,537,6185,608061,535187,548971,399053,333053,194928,161555,16006,2188753,876443,3065196,1875174,673742,407193,3809,1555,91,60
Bihar,Saharsa,25.821270696721303,86.54670819672135,214,1900661,997174,903487,804996,506374,298622,1629254,266620,1292,197,60,109,8,3121,470697,348300,194897,104182,90182,64560,47051,6016,855188,1151349,2006537,1249692,415863,233870,1236,1582,90,42
Bihar,Samastipur,25.793205563909765,85.94833323308269,221,4261566,2230003,2031563,2142880,1293575,849305,3800598,452370,2126,554,292,231,112,5283,1056465,781038,710468,438908,284082,186153,129933,19126,2549708,1996651,4546359,2766930,913339,568812,12485,3500,91,50
Bihar,Saran,25.89656077844312,84.82266287425155,219,3951862,2022821,1929041,2157454,1285767,871687,3534772,406449,2330,371,229,322,107,7282,777622,793945,693465,433759,361171,213251,148065,9848,2653504,1313700,3967204,2516115,847031,585386,3330,3667,95,54
Bihar,Sheikhpura,25.12472436548223,85.77839390862943,228,636342,329743,306599,328676,196431,132245,596102,37653,313,75,41,43,31,2084,132638,129673,110525,59529,52860,33856,19676,3399,409518,305609,715127,413475,136898,85045,924,565,92,51
Bihar,Sheohar,26.458380748663107,85.29539411764709,205,656246,346673,309573,283698,171645,112053,552492,99342,522,216,73,52,44,3505,166000,128209,91277,37063,25657,16031,10091,661,308989,348078,657067,421241,139909,93398,1698,489,89,43
Bihar,Sitamarhi,26.56570069686413,85.61172491289203,206,3423574,1803252,1620322,1436794,885188,551606,2672311,740101,2897,261,253,188,20,7543,856964,733380,394422,196321,136500,92783,70549,11936,1635891,1852765,3488656,2206340,739982,449035,28217,2679,89,41
Bihar,Siwan,26.1736372013652,84.33766552901022,218,3330464,1675090,1655374,1930175,1115906,814269,2712635,608282,2618,369,407,359,86,5708,674372,689880,612635,445257,355277,186817,119164,12091,2421121,1207119,3628240,2115448,713597,498299,3120,3014,98,57
Bihar,Supaul,26.28157893772896,86.78496465201461,208,2229076,1155283,1073793,1033283,647672,385611,1809936,409251,3758,271,136,546,42,5136,600102,467768,269737,157787,99530,69665,45726,5850,1116063,1220268,2336331,1453438,495020,277610,3008,1836,92,46
Bihar,Vaishali,25.8134703180212,85.39247597173153,220,3495021,1844535,1650486,1926740,1152576,774164,3152346,333980,2203,707,362,246,71,5106,750811,810191,487594,370247,291392,178320,124448,9094,2271286,1479152,3750438,2176701,759132,486032,73156,2930,89,55
Chandigarh,Chandigarh,30.7426,76.75872465753424,55,1055450,580663,474787,805438,465346,340092,852574,51447,8720,138329,1160,1960,246,1014,298367,80406,118667,114209,124707,98786,174528,20188,731491,184265,915756,602411,303748,148945,346,34145,81,76
Chhattisgarh,Bastar,19.393866751269048,81.52895126903546,414,1413199,698487,714712,650863,382335,268528,1277975,12413,27951,2099,985,3466,86925,1385,371319,183667,178766,139330,60936,57413,32895,3227,656234,729550,1385784,864272,358157,189569,1201,1529,102,46
Chhattisgarh,Bilaspur,22.356942982456143,81.99770350877188,30,381956,192764,189192,287620,155599,132021,371973,6984,236,2387,113,10,7,246,164445,35817,59489,53515,64730,45695,25474,3241,287961,65864,353825,193671,107367,80497,421,3666,98,75
Chhattisgarh,Bilaspur,22.356942982456143,81.99770350877188,406,2663629,1351574,1312055,1596560,932474,664086,2540763,57973,20745,6373,2979,2357,29122,3317,737806,382091,407692,337793,189296,152838,134637,19654,1624001,943112,2567113,1625484,655032,380114,2999,2981,97,59
Chhattisgarh,Dhamtari,20.554912627291245,81.7569195519348,412,799781,397897,401884,546833,303924,242909,777188,10425,2644,1196,667,3612,3685,364,210481,143128,148544,120146,65196,58875,31319,5096,572304,214637,786941,461125,213021,125429,206,782,101,68
Chhattisgarh,Durg,21.194463849287164,81.33181639511197,409,3343872,1682101,1661771,2303378,1284612,1018766,3129745,83499,24304,24276,19587,17209,42569,2683,883189,463598,573291,497668,309508,286244,202424,30555,2363288,823501,3186789,1919832,898241,523656,2143,4209,98,68
Chhattisgarh,Jashpur,22.77286167664669,83.8703962075848,402,851669,424747,426922,495415,280656,214759,629509,15336,189588,474,467,694,14835,766,226392,120768,137681,127299,64188,50562,26161,3166,529825,328438,858263,488965,214455,148100,149,856,100,58
Chhattisgarh,Korba,22.491712499999995,82.57604326923074,404,1206640,612915,593725,748759,433391,315368,1133176,30195,21059,3666,897,753,15649,1245,332653,178191,188303,168387,89167,83166,61215,11792,780221,410186,1190407,729708,309479,166959,494,1565,96,62
Chhattisgarh,Koriya,23.50412776859501,82.12515636363635,400,658917,334737,324180,397823,229923,167900,604259,25878,9398,1391,84,1155,15474,1278,181615,143413,109639,87969,47127,38677,26802,4134,457761,179639,637400,399581,165022,94073,241,852,96,60
Chhattisgarh,Mahasamund,21.223727037773354,82.65925427435384,411,1032754,511967,520787,637963,364089,273874,1008061,12570,5284,2941,521,1495,1417,465,310567,179770,194739,152183,78583,57949,33357,5951,702532,384764,1087296,582544,272009,177826,375,964,101,61
Chhattisgarh,Raigarh,22.008265068493166,83.27797698630134,403,1493984,750278,743706,951639,542756,408883,1422986,17332,47653,2117,781,409,1782,924,420916,246480,260661,210964,130700,93340,66358,8804,1017307,460166,1477473,841958,398257,253488,281,1575,99,63
Chhattisgarh,Raigarh,22.008265068493166,83.27797698630134,520,2634200,1344345,1289855,1939994,1059692,880302,2239370,227465,17452,7477,121791,12260,1159,7226,959028,231263,407662,335886,441072,221410,204507,19940,1861740,482420,2344160,1414154,748339,462741,8966,6097,95,73
Chhattisgarh,Raipur,20.88603153846152,82.20032759615388,410,4063872,2048186,2015686,2629749,1493158,1136591,3881485,103038,23181,16707,8397,17137,10680,3247,1068500,618508,664470,552373,313247,267265,227382,31483,2674728,1247434,3922162,2454299,1038155,560184,11234,4561,98,64
Chhattisgarh,Surguja,23.32719278728607,83.23582493887531,401,2359886,1193129,1166757,1187941,694686,493255,2126195,81442,97432,2303,1287,623,48295,2309,590763,364452,338509,281260,135374,105992,64607,9524,1299718,991866,2291584,1441436,561915,355077,1458,2462,97,50
Daman and Diu,Daman,20.431616666666677,72.8392366071429,495,191173,124659,66514,150348,104316,46032,171537,16087,2618,169,216,244,79,223,71079,8957,28094,30406,26991,14170,9128,1995,119741,20641,140382,122589,52868,15428,288,34145,53,78
Daman and Diu,Junagadh,20.72568199498111,70.83985639899612,479,2743082,1404356,1338726,1842818,1046981,795837,2397056,334858,2586,1110,1291,3841,77,2263,776743,271762,700258,294811,311849,137505,139957,30127,1886269,669022,2555291,1527888,749156,461650,4388,5549,95,67
Goa,North Goa,15.548723418714054,73.80667997909038,585,818008,416677,401331,663060,351738,311322,622213,57941,134169,618,553,546,166,1802,325089,40968,101521,148792,153887,87513,86781,16601,636063,99538,735601,380926,260533,175035,1514,2078,96,81
Goa,South Goa,15.195278658183785,73.941792596877,586,640537,322463,318074,502427,264085,238342,341664,63623,231961,855,542,563,92,1237,251493,29874,73039,119869,108989,64786,57460,9579,463596,88577,552173,314480,194872,130605,580,1646,98,78
Gujarat,Ahmadabad,22.605425564971743,72.23898135593227,474,7214225,3788051,3426174,5435760,3025463,2410297,6042416,883238,50754,14542,4518,209287,2055,7415,2198552,761358,1614370,805199,1135058,549188,839295,100831,5805299,1129562,6934861,3952858,2043895,1198152,19320,18633,90,75
Gujarat,Amreli,21.04832649310872,71.43457637825426,480,1514190,771049,743141,995459,558180,437279,1410463,99105,919,415,243,2053,40,952,430613,230474,412251,120625,149478,66785,50999,8582,1039194,380595,1419789,836343,389892,282409,5546,2825,96,65
Gujarat,Anand,22.282718206229863,72.57782051557454,482,2092745,1087224,1005521,1551253,874481,676772,1798794,250919,29789,1524,267,8591,142,2719,621987,257524,560542,229013,283571,127459,110351,20487,1588947,360506,1949453,1134962,585093,366419,6271,4372,92,74
Gujarat,Banas Kantha,24.258538965517253,71.93205252873561,469,3120506,1610379,1510127,1704923,1048402,656521,2890305,213505,1686,486,281,12659,83,1501,804197,366867,859436,159433,226765,105372,66950,14451,1799274,1207376,3006650,1984701,738412,394793,2600,4242,93,54
Gujarat,Bharuch,21.75787276237761,72.67326346710801,488,1551019,805707,745312,1118276,623047,495229,1188204,343511,9494,1733,442,4813,342,2480,481996,161675,367060,164765,188539,83895,74380,16036,1056350,273829,1330179,844298,442523,254728,9470,3242,92,72
Gujarat,Bhavnagar,21.70219390341736,72.16272632761141,481,2880365,1490201,1390164,1887255,1087371,799884,2632574,212863,3457,1410,445,26974,127,2515,744077,422461,929286,266953,281250,96241,93391,13946,2103528,508664,2612192,1708938,720241,445121,6065,5434,93,65
Gujarat,Gandhinagar,23.193679790026252,72.67221679790026,473,1391753,723864,667889,1030494,582686,447808,1319586,57273,3237,1985,497,6405,82,2688,433258,136131,363156,133594,196456,95730,108400,16088,1049555,246993,1296548,769329,391862,224886,5676,6016,92,74
Gujarat,Jamnagar,22.410600414263328,69.62062005768233,477,2160119,1114192,1045927,1396534,795140,601394,1810443,320805,4392,1873,1086,18856,136,2528,646325,255785,491009,194057,199634,74029,87523,18573,1320610,502873,1823483,1220598,576319,358455,4747,5028,93,64
Gujarat,Junagadh,20.929523011609785,70.54733890140345,479,2743082,1404356,1338726,1842818,1046981,795837,2397056,334858,2586,1110,1291,3841,77,2263,776743,271762,700258,294811,311849,137505,139957,30127,1886269,669022,2555291,1527888,749156,461650,4388,5549,95,67
Gujarat,Kachchh,23.48057203301311,68.82192301497916,468,2092371,1096737,995634,1252319,739239,513080,1608921,442355,6192,6353,490,25312,98,2650,739275,246956,469402,141345,157284,61366,60386,14062,1150801,581952,1732753,1278604,524052,286086,3629,4146,90,59
Gujarat,Kheda,22.88765312500002,73.018803515625,483,2299885,1185727,1114158,1660243,942480,717763,2000884,264482,26629,1403,300,3479,82,2626,622026,295057,641541,250044,310341,148530,84223,19498,1749234,482078,2231312,1260660,628221,388646,22358,4252,93,72
Gujarat,Mahesana,23.529355452865065,72.45545194085031,471,2035064,1056520,978544,1502645,847499,655146,1885732,136431,1954,1082,146,7087,88,2544,659743,260278,467128,183468,266108,139208,130723,27391,1474304,434497,1908801,1119451,554432,357578,3603,3648,92,73
Gujarat,Narmada,21.70666386292833,73.68403208722742,487,590297,301086,289211,370336,211767,158569,559848,22600,4413,147,80,373,2078,758,160369,76197,146661,58188,52687,28396,14748,3451,380328,192780,573108,336830,157910,93466,2091,979,96,62
Gujarat,Navsari,20.866973318871995,72.86184869848157,490,1329672,678165,651507,1001909,539471,462438,1225087,78669,5733,2459,601,13386,2823,914,409156,145678,266733,140235,190861,112460,85041,26012,967020,261956,1228976,673014,390349,258957,7352,3256,96,75
Gujarat,Panch Mahals,22.80435606837605,73.61984598290586,484,2390776,1226961,1163815,1440805,858054,582751,2220974,158513,2863,662,337,5236,131,2060,567601,255905,601358,205420,283648,139773,71810,17958,1575872,781582,2357454,1421859,599925,363391,5601,3981,94,60
Gujarat,Patan,23.80634198473284,71.75162977099237,470,1343734,694397,649337,837913,494631,343282,1194745,142797,916,337,66,3602,66,1205,404138,168990,364667,78731,129584,57494,46355,11111,856932,452891,1309823,786357,341381,213465,2531,2199,93,62
Gujarat,Porbandar,21.55092351651571,69.71896987722886,478,585449,300209,285240,393678,221621,172057,549749,33565,500,248,91,515,38,743,183572,50588,150643,71637,63458,25119,22458,5260,389163,137119,526282,314886,163777,105638,1148,1463,95,67
Gujarat,Rajkot,22.40603377715488,70.83679439383323,476,3804558,1974445,1830113,2725056,1514075,1210981,3397406,361388,5478,1918,1170,33591,269,3338,1181006,383780,913928,402240,540278,204306,266295,29924,2740751,738660,3479411,2080568,1052871,659576,11543,8498,92,71
Gujarat,Sabar Kantha,23.71803594548552,73.13638790459964,472,2428589,1244231,1184358,1578734,918625,660109,2260560,148563,6375,614,168,11110,52,1147,665533,214062,597667,211423,333650,198963,110817,24745,1691327,665058,2356385,1393131,630963,400905,3590,3934,95,65
Gujarat,Surat,21.25761372772093,72.93488716344339,492,6081322,3402224,2679098,4571410,2687468,1883942,5260193,660772,21052,5703,12902,112835,3920,3945,1899838,566242,1332690,807021,896927,433651,379505,79862,4495898,942150,5438048,3563443,1740746,723415,53718,16368,78,75
Gujarat,Surendranagar,22.82672007299272,71.48358740875906,475,1756268,909917,846351,1093626,643221,450405,1620282,109681,1419,512,312,22992,128,942,500598,234873,482679,165406,172947,61164,58389,14501,1189959,493427,1683386,1033435,439352,280582,2899,3227,93,62
Gujarat,The Dangs,20.801633877551023,73.6883518367347,489,228291,113821,114470,140968,77314,63654,203545,3593,20029,69,32,39,560,424,59618,43639,59954,17736,14872,7560,3490,2215,149466,91160,240626,146095,51821,30027,348,325,100,61
Gujarat,Vadodara,22.26133739279589,73.49433010291594,486,4165626,2153736,2011890,2893080,1614087,1278993,3713941,384579,23813,9340,2069,27650,1124,3110,1240425,396624,865726,457662,504732,268451,314960,60177,2868332,910219,3778551,2213474,1190041,733710,28401,9753,93,69
Gujarat,Valsad,20.44238231644259,72.9148584798345,491,1705678,887222,818456,1170657,655528,515129,1571147,94034,19661,1589,913,13809,1417,3108,498391,165459,303197,171712,212318,123281,90912,26987,1093866,405928,1499794,944532,485874,259906,15366,3316,92,68
Haryana,Ambala,30.3503672316384,76.94970310734456,70,1128350,598703,529647,818025,461288,356737,955096,22143,3705,138202,381,4845,110,3868,315256,89558,170110,161844,163544,97980,91472,18727,793235,222031,1015266,617859,308126,201685,680,2781,88,72
Haryana,Bhiwani,28.728868064516128,76.02110225806452,81,1634445,866672,767773,1069871,643158,426713,1611031,15515,873,2401,254,1016,26,3329,456282,186145,223049,198307,218631,148995,104875,13786,1093788,459364,1553152,964960,405760,261428,2297,3349,88,65
Haryana,Faridabad,28.14873109756098,77.32718536585368,88,1809733,966110,843623,1272739,734940,537799,1588407,161680,9743,34572,640,4883,249,9559,470681,137902,220384,198551,282666,178846,259933,27864,1306146,346567,1652713,1095602,481318,231029,1784,5080,87,70
Haryana,Fatehabad,29.57298318584072,75.54608716814157,78,942011,495360,446651,557578,327471,230107,779243,8360,996,150969,171,1172,530,570,258380,103541,136663,99948,93526,61476,37741,9504,542399,344534,886933,555745,237009,147469,1788,1854,90,59
Haryana,Gurgaon,28.043894789579163,77.01935130260523,86,1514432,816690,697742,1111116,638666,472450,1408801,70842,9725,15097,944,7451,254,1318,523691,126920,177453,175370,219200,150120,233402,41366,1123831,263720,1387551,875531,428101,210307,493,3107,85,73
Haryana,Hisar,29.23628731117825,75.84324682779452,80,1743931,931562,812369,1114311,670200,444111,1701061,21650,1945,12270,334,3620,33,3018,456126,197303,230074,194595,202792,144626,105346,19031,1093767,505251,1599018,1017830,456536,265109,4456,3642,87,63
Haryana,Jhajjar,28.59651868131869,76.61137142857145,83,958405,514667,443738,676091,399480,276611,945693,8247,734,1042,105,645,22,1917,290144,90737,109829,115794,145258,97457,58826,9387,627288,201028,828316,549975,245095,162356,979,2169,86,70
Haryana,Jind,29.45149821958457,76.29598575667653,77,1334152,713006,621146,832758,502049,330709,1276669,23016,889,29103,172,2594,56,1653,368000,136892,185626,151682,154773,107994,64599,14277,815843,419624,1235467,784085,335704,213478,885,2674,87,62
Haryana,Kaithal,29.96068539094649,76.37698930041155,73,1074304,571003,503301,646529,385782,260747,974520,8232,1769,87558,265,351,70,1539,306787,119345,158239,124682,117753,82297,51043,9111,662470,369869,1032339,630194,265813,176320,1977,2046,88,60
Haryana,Karnal,29.703200647249204,76.87488025889972,74,1505324,797712,707612,978013,564516,413497,1341002,31650,2049,126207,532,1516,49,2319,428602,155839,231354,188040,183590,124790,101387,19186,1004186,429220,1433406,884972,380409,234684,5259,3368,88,64
Haryana,Kurukshetra,30.05652659846548,76.78774680306903,72,964655,510976,453679,646893,370828,276065,805175,15970,1943,140395,214,375,106,477,291821,94530,145392,118107,120790,81964,71007,10999,642789,266638,909427,552034,250830,160216,1575,2137,88,67
Haryana,Mahendragarh,28.1352161458333,76.14018072916659,84,922088,486665,435423,630255,380440,249815,913251,5660,301,1737,75,644,15,405,267942,94273,135849,126291,132765,94245,60296,10353,654072,245602,899674,530000,229392,161258,1438,1894,89,68
Haryana,Panchkula,30.700897142857134,76.97173238095236,69,561293,299679,261614,405318,229862,175456,490702,23451,2583,40951,1008,1626,90,882,164551,45607,73584,60177,69163,48306,83256,8466,388559,119222,507781,309078,157076,93606,1533,1445,87,72
Haryana,Panipat,29.34352134146342,76.92895914634147,75,1205437,646857,558580,786599,464136,322463,1083936,86622,2261,25064,289,4647,99,2519,327306,118873,170565,143466,141473,91756,75774,10977,752884,296212,1049096,739075,298764,167244,354,2559,86,65
Haryana,Rewari,28.19164714828897,76.55956007604564,85,900332,474335,425997,636947,375453,261494,889133,5713,701,1804,202,1525,12,1242,268754,81280,120860,122617,139646,95807,65143,9820,635173,206827,842000,518747,230704,150557,324,1979,89,70
Haryana,Rohtak,28.892517647058817,76.53123235294117,82,1061204,568479,492725,747582,436025,311557,1043887,8185,732,3916,200,3491,24,769,306942,117097,150903,140782,168499,109596,100346,21134,808357,248795,1057152,605741,269354,185685,424,2299,86,70
Haryana,Sirsa,29.63583446327684,74.90970480225988,79,1295189,682582,612607,782897,456968,325929,940255,9524,2186,338962,370,2256,624,1012,338792,141766,201349,153263,134559,83373,61620,16698,792628,412353,1204981,750228,334344,208185,2432,2681,89,60
Himachal Pradesh,Bilaspur,31.3780422907489,76.65316079295157,30,381956,192764,189192,287620,155599,132021,371973,6984,236,2387,113,10,7,246,164445,35817,59489,53515,64730,45695,25474,3241,287961,65864,353825,193671,107367,80497,421,3666,98,75
Himachal Pradesh,Bilaspur,31.3780422907489,76.65316079295157,406,2663629,1351574,1312055,1596560,932474,664086,2540763,57973,20745,6373,2979,2357,29122,3317,737806,382091,407692,337793,189296,152838,134637,19654,1624001,943112,2567113,1625484,655032,380114,2999,2981,97,59
Himachal Pradesh,Chamba,32.66741814595661,76.39354063116366,23,519080,261320,257760,323842,186064,137778,479782,32455,1559,2745,1740,57,14,728,200231,56272,96789,67653,64515,40440,15506,3252,344427,154575,499002,306555,130606,81566,353,950,98,62
Himachal Pradesh,Hamirpur,31.67668481012659,76.49767088607594,28,454768,217070,237698,358091,180555,177536,449412,3711,243,591,95,293,9,414,211348,37327,71107,72114,91184,64363,35620,5263,376978,72551,449529,224044,123941,106641,142,878,109,78
Himachal Pradesh,Hamirpur,31.67668481012659,76.49767088607594,168,1104285,593537,510748,653299,408125,245174,1010014,91269,814,196,74,41,273,1604,311381,159593,238344,211029,103334,59914,59612,4094,835920,364848,1200768,660774,260368,181109,2034,1291,86,59
Himachal Pradesh,Kangra,32.14093603238864,76.41205910931173,24,1510075,750591,759484,1152640,606443,546197,1461140,19797,3023,8929,14511,194,208,2273,627328,127699,243617,223099,284124,192936,91236,13577,1176288,271892,1448180,766581,419172,319420,4902,2878,101,76
Himachal Pradesh,Kinnaur,31.60667184065933,78.51613736263741,34,84121,46249,37872,60699,36697,24002,64732,448,485,249,18086,29,45,47,44514,9400,13749,11437,11140,7871,5118,713,59428,16944,76372,42360,26599,15075,87,181,81,72
Himachal Pradesh,Kullu,31.90911922077925,77.40922649350647,26,437903,225452,212451,307672,174550,133122,415669,2974,1568,1396,15377,94,83,742,188704,48384,77363,61854,58122,39081,23168,2377,310349,103136,413485,244727,120510,72282,384,854,94,70
Himachal Pradesh,Mandi,31.635805940594054,76.96556930693067,27,999777,498065,501712,723747,393669,330078,981412,9460,876,4081,2628,43,86,1191,462825,100052,159043,132147,180188,128549,54139,9350,763468,218570,982038,524285,279321,194661,1510,1842,100,72
Himachal Pradesh,Shimla,31.155725451807253,77.62573042168668,33,814010,425039,388971,612642,342846,269796,791449,11810,2025,4047,3262,185,197,1035,375165,69967,113536,113305,141490,95341,80414,9748,623801,137576,761377,425721,241956,145577,756,1668,91,75
Himachal Pradesh,Sirmaur,30.682764453961443,77.43184689507493,32,529855,276289,253566,362645,205617,157028,476830,33215,577,15501,2645,236,86,765,192156,57853,100123,78103,67080,38282,23352,4048,368841,140486,509327,310244,136839,82471,301,930,91,68
Himachal Pradesh,Solan,31.03864311926604,76.94442140672783,31,580320,308754,271566,428578,244372,184206,548579,14678,1452,13926,574,591,110,410,244296,50331,89407,83992,95232,59363,36803,8280,423408,104084,527492,321533,167168,90808,811,1253,87,73
Himachal Pradesh,Una,31.58330388349513,76.18353932038836,29,521173,263692,257481,399715,213281,186434,480138,14275,390,26009,56,70,10,225,205217,51838,87913,81256,105204,60626,32120,5511,424468,87735,512203,273223,142351,105358,241,987,97,76
Jammu and Kashmir,Doda,33.359614675767915,76.07163720136518,16,409936,213641,196295,219083,138620,80463,187621,220614,472,422,21,22,42,722,133617,43794,47350,62719,48359,31416,12647,1846,248131,163565,411696,263576,93189,52744,427,1103,91,53
Jammu and Kashmir,Jammu,32.713199095022645,74.8477520361991,21,1529958,813821,716137,1137135,641916,495219,1289240,107489,12104,114272,470,1987,321,4075,502609,135391,185962,253542,261852,159257,146501,30616,1173121,268279,1441400,816827,435895,275585,1651,3525,87,74
Jammu and Kashmir,Kargil,33.565994894894914,76.63675315315312,4,140802,77785,63017,86236,56301,29935,10341,108239,604,1171,20126,28,4,289,48144,12732,19083,20874,16938,9826,3077,408,82938,39854,122792,87532,35561,17488,221,214,81,61
Jammu and Kashmir,Kathua,32.51781678321678,75.58901398601404,7,616435,326109,290326,389204,228499,160705,540063,64234,1828,9551,24,16,2,717,214847,69396,82715,106411,91522,47694,24330,4504,426572,181297,607869,357864,160123,97684,764,936,89,63
Jammu and Kashmir,Pulwama,33.88414418604652,75.00921860465118,12,560440,293064,267376,293958,178326,115632,13840,535159,1109,9440,35,6,18,833,169223,36201,54808,73991,67368,40931,31286,5897,310482,190369,500851,342601,137032,80111,696,1068,91,52
Jammu and Kashmir,Punch,33.791241290322574,74.29593161290322,5,476835,251899,224936,261724,163333,98391,32604,431279,958,11188,83,10,2,711,147408,55762,72024,69219,46062,29517,13962,1884,288430,164044,452474,304979,109818,61334,704,629,89,54
Jammu and Kashmir,Srinagar,34.27312898550724,75.11021159420288,10,1236829,651124,585705,748584,431746,316838,42540,1177342,2746,12187,285,74,2,1653,262239,88911,173309,178723,176409,132727,121856,32114,904049,310225,1214274,693238,351561,190330,1700,3099,89,60
Jammu and Kashmir,Udhampur,33.04770670731707,75.15286951219511,19,554985,296784,258201,322354,197543,124811,489044,59771,1962,3418,106,57,235,392,183360,58567,80129,86008,55024,29657,17345,4030,330760,194838,525598,339145,140785,74757,298,1278,86,58
Jharkhand,Bokaro,23.6814965034965,85.98398374125864,355,2062330,1072807,989523,1273520,759088,514432,1636460,241451,13730,4174,1890,2045,160524,2056,508764,242467,338861,342646,232434,154076,116396,21157,1448037,595924,2043961,1261238,510375,282115,8602,3604,92,61
Jharkhand,Chatra,24.11619945750453,84.93295804701627,347,1042886,533935,508951,510061,303902,206159,903179,116710,6565,888,35,129,12936,2444,215502,200861,161729,102033,63670,35342,21697,2046,587378,467975,1055353,692650,222892,126682,662,817,95,48
Jharkhand,Deoghar,24.33070100755672,86.75697632241814,350,1492073,775022,717051,793538,489837,303701,1165140,302626,6027,143,188,282,16067,1600,321710,217460,266292,190171,96331,54419,43979,6699,875351,635544,1510895,944961,338413,205514,3185,1267,92,53
Jharkhand,Dhanbad,23.854509090909097,86.40372924901185,354,2684487,1405956,1278531,1722204,1014950,707254,2149480,431762,11243,9727,331,1268,77182,3494,664219,317918,501453,449506,305054,186697,107382,14615,1882625,662522,2545147,1634835,648876,356445,44331,3954,90,64
Jharkhand,Dumka,24.275006125574265,87.27662450229711,362,1321442,668514,652928,672409,406275,266134,1044726,106865,86404,234,267,162,78622,4162,326978,229157,229259,149009,69525,38383,25593,2697,743623,601078,1344701,799323,324226,196164,1729,1323,97,50
Jharkhand,Garhwa,24.082114689265527,83.68664265536722,346,1322784,683575,639209,653476,405161,248315,1104475,194680,17168,123,371,20,4591,1356,292052,207665,195565,147446,87844,46882,28144,2830,716376,557852,1274228,860869,284036,177599,280,1017,93,49
Jharkhand,Giridih,24.30578509874329,86.08710915619386,349,2445474,1258098,1187376,1253475,783736,469739,1856202,508586,14645,937,650,1503,59218,3733,499450,503261,443980,261309,146464,77540,55122,8449,1496125,1047685,2543810,1597269,533788,312967,1450,2384,94,51
Jharkhand,Godda,24.8189,87.2941735483871,351,1313551,677927,635624,604519,376212,228307,937126,289182,37795,97,128,115,47067,2041,292030,217607,190777,126766,79430,47395,30870,4002,696847,653464,1350311,820367,308639,183519,1026,1057,93,46
Jharkhand,Gumla,23.078532948929148,84.55056787479396,366,1025213,514390,510823,559720,321795,237925,309563,51429,202449,221,531,23,457468,3529,233074,136719,242580,182260,82114,45613,23742,2913,715941,322119,1038060,643579,225871,155452,311,849,99,54
Jharkhand,Jamtara,23.97873318077801,86.95325080091534,363,791042,404830,386212,426312,258260,168052,550560,164406,4419,520,118,783,68564,1672,185668,131150,132014,85745,40613,22995,14802,1578,428897,366012,794909,480895,189889,116810,3448,540,95,53
Jharkhand,Latehar,23.72511185840708,84.48298743362837,359,726978,369666,357312,350682,209706,140976,473049,69808,47653,120,128,16,133525,2679,160514,109491,121529,88787,46142,23885,13956,1017,404807,349277,754084,484084,152720,89870,304,547,96,48
Jharkhand,Lohardaga,23.488796043165483,84.6605169064748,356,461790,232629,229161,259707,149568,110139,112378,95012,16770,51,33,15,235987,1544,111484,82873,84920,63545,38503,21987,13847,976,306651,188323,494974,298844,100340,62244,362,388,98,56
Jharkhand,Pakur,24.57260428082189,87.69691969178076,353,900422,452661,447761,352881,206989,145892,410127,322963,75865,356,283,222,88760,1846,217175,100367,133770,79045,29934,15700,9822,1525,370163,548434,918597,587976,206826,104418,1202,691,98,39
Jharkhand,Palamu,24.196925968109337,84.20310842824594,358,1939869,1006302,933567,1024563,621706,402857,1683169,238295,6164,734,188,284,5681,5354,407904,303053,296937,231565,160964,100290,63595,7117,1163521,803424,1966945,1244572,425668,268387,1242,1515,92,52
Jharkhand,Ranchi,23.184235061391547,85.31781937244203,364,2914253,1494937,1419316,1911433,1085244,826189,1612239,410759,193974,4826,932,2733,677445,11345,730982,361522,547583,495515,370847,247237,195181,28424,2246309,613855,2860164,1742293,725938,409166,36856,3805,94,65
Jharkhand,Sahibganj,24.93667989690721,87.68264097938142,352,1150567,589391,561176,483263,287303,195960,628044,398243,83208,198,245,125,38426,2078,260993,146399,171416,110822,52248,28087,19832,2593,531397,637296,1168693,745027,261849,137727,5964,954,95,42
Jharkhand,Simdega,22.608760391198054,84.59193691931536,367,599578,300309,299269,343483,191991,151492,201524,15103,306601,51,753,114,73930,1502,155283,82317,130068,97580,47836,24842,13674,1197,397514,191341,588855,357859,143560,97817,342,496,99,57
Karnataka,Bagalkot,16.15860676328503,75.64526070853468,556,1889752,950111,939641,1113412,641388,472024,1634229,219991,3433,443,412,25198,166,5880,490657,242336,385986,147397,171505,115095,82319,25791,1170429,608843,1779272,1123443,465706,299774,829,2890,98,58
Karnataka,Bangalore Rural,12.936827087794448,77.47369314775169,583,990923,509172,481751,688749,385311,303438,890429,92252,5368,389,272,1045,85,1083,326462,100770,168165,126285,166677,82235,51015,10741,705888,205062,910950,535765,278153,176083,922,1422,94,69
Karnataka,Belgaum,16.16107219152853,74.72329042357275,555,4779661,2423063,2356598,3052032,1725548,1326484,4038331,528412,18418,2037,1086,178310,149,12918,1318975,544564,1057297,609600,532584,279583,201884,56621,3282133,1346776,4628909,2669348,1251116,857143,2054,7045,97,63
Karnataka,Bellary,15.074377548209377,76.47228471074374,565,2452595,1236954,1215641,1421621,813440,608181,2103633,320834,14014,1029,284,8044,54,4703,623480,275785,529576,219702,203139,121453,89475,29367,1468497,787762,2256259,1487013,617276,346905,1401,3886,98,57
Karnataka,Bidar,17.950361730769224,77.19459961538459,558,1703300,870665,832635,1042673,597198,445475,1289709,335184,35438,1145,30453,680,521,10170,389403,188998,474921,194233,181076,105347,54900,12885,1212360,515395,1727755,1018195,397120,287271,714,2448,95,61
Karnataka,Bijapur,16.84015316666667,75.95909166666665,417,255230,128663,126567,86919,54076,32843,245151,1617,2709,68,1649,15,3793,228,58391,25597,22787,14170,7192,6755,3421,147,80069,163278,243347,167348,63802,23927,153,1387,98,34
Karnataka,Bijapur,16.84015316666667,75.95909166666665,557,2177331,1111022,1066309,1248268,730566,517702,1786830,369588,2433,558,374,8665,499,8384,527490,246391,430477,143199,182756,129109,96990,24569,1253491,746979,2000470,1295274,527085,353549,1423,2938,95,57
Karnataka,Chikmagalur,13.425288289676422,75.67626502311249,570,1137961,566622,571339,818345,438257,380088,1004553,101235,26000,182,109,4710,4,1168,392426,114570,257550,160083,177585,96470,72420,12631,891309,204371,1095680,564994,341380,230864,723,1996,100,71
Karnataka,Chitradurga,14.29102220394736,76.57821957236843,566,1659456,840843,818613,1087392,607188,480204,1520553,128751,3175,322,84,3778,128,2665,447348,188329,332648,196470,217567,132435,75262,22078,1164789,452975,1617764,891230,460057,306412,1757,2374,97,65
Karnataka,Davanagere,14.330414586709884,75.91723841166937,567,1945497,986400,959097,1308540,720637,587903,1658465,265805,5420,307,164,6417,1743,7176,530691,242130,446793,206686,269748,154781,123863,32375,1476376,467414,1943790,1068518,538551,336173,2255,3062,97,67
Karnataka,Dharwad,15.343831376975173,75.13831264108359,562,1847023,937206,909817,1301664,711776,589888,1390020,386834,28747,1486,715,29037,2748,7436,483104,252596,383041,185530,227113,143453,137768,34302,1363803,428556,1792359,1017935,505688,322577,823,3519,97,70
Karnataka,Gadag,15.507128256880746,75.64861302752298,561,1064570,537147,527423,700177,397178,302999,907750,143665,3432,231,79,5993,74,3346,291972,121615,244640,112703,105150,63816,42053,12822,702799,306138,1008937,601578,279069,183409,514,1699,98,65
Karnataka,Gulbarga,17.070459515951594,76.87503850385033,579,2566326,1301755,1264571,1427368,828359,599009,2011014,513125,8344,826,9589,4865,330,18233,600007,177860,579057,270622,290570,153746,104256,20492,1596603,883704,2480307,1570719,604665,388935,2007,5378,97,55
Karnataka,Hassan,12.945098749999998,76.11049549999997,574,1776421,883667,892754,1225256,668836,556420,1630814,120011,15611,289,623,5820,3,3250,628981,182255,354480,232531,292369,147837,103152,27774,1340398,401227,1741625,877340,522039,375918,1124,2743,101,68
Karnataka,Haveri,14.737582809224318,75.3961230607966,564,1597668,819128,778540,1085443,603793,481650,1281878,297927,2406,419,68,9834,702,4434,413564,240925,430529,201965,158442,84357,55310,16830,1188358,383494,1571852,904453,426094,266586,535,2240,95,67
Karnataka,Kodagu,12.39684468085106,75.79336595744688,576,554519,274608,279911,412877,215302,197575,448986,87274,17130,139,126,250,220,394,212974,51287,111562,75291,86232,54939,43225,8251,430787,91352,522139,276918,163360,113919,322,942,101,74
Karnataka,Kolar,13.312799881235172,78.01376947743476,581,1536401,776396,760005,1016219,564110,452109,1305431,199873,26722,253,150,2494,92,1386,477609,138015,289841,228422,225498,107929,71422,17961,1079088,399089,1478177,841499,419380,274240,1282,3389,97,66
Karnataka,Koppal,15.651253271028034,76.1617048598131,560,1389920,699926,689994,809085,468785,340300,1218024,161770,4081,296,85,2898,461,2305,337649,222140,357098,127605,113028,72243,43967,10431,946512,472182,1418694,855430,330393,202984,1113,1889,98,58
Karnataka,Mandya,12.574901806239744,76.81570098522172,573,1805769,905085,900684,1149649,638668,510981,1712695,77801,8506,322,299,3607,109,2430,562302,145178,309476,226552,308624,157839,102838,19987,1270494,504734,1775228,902307,527236,375100,1126,2628,99,63
Karnataka,Mysore,12.248100259403367,76.52881802853437,577,3001127,1511600,1489527,1962180,1063766,898414,2631985,290549,39361,1255,16194,14419,493,6871,920982,207091,537686,404565,452412,222230,212541,26834,2063359,747237,2810596,1580116,865220,553705,2086,4995,98,65
Karnataka,Raichur,16.050795353982295,76.87368606194688,559,1928812,964511,964301,979769,577213,402556,1634062,272022,10394,538,2265,4156,29,5346,455848,147743,385673,163709,153346,82082,50463,14622,997638,783126,1780764,1196670,465173,265810,1159,2672,99,50
Karnataka,Shimoga,14.063845885634592,75.17882078103197,568,1752753,877415,875338,1263016,674938,588078,1479424,234664,26521,400,120,9234,367,2023,554106,191641,385978,292481,251095,132138,111753,18036,1383122,355222,1738344,913150,513297,325542,764,3119,99,72
Karnataka,Tumkur,13.592467760074973,77.02297966260545,571,2678980,1350594,1328386,1813391,1006024,807367,2413812,245923,9130,477,187,5067,161,4223,890242,270373,500593,386998,423738,213588,143735,30687,1969712,686274,2655986,1351461,760936,564196,2387,4067,98,67
Karnataka,Udupi,13.450404228534568,74.72009990316337,569,1177361,562131,615230,926429,465704,460725,1009179,96740,65838,232,161,4534,155,522,385389,142493,286193,176260,178094,109663,107279,18444,1018426,204028,1222454,559565,340903,276234,659,2100,109,78
Kerala,Alappuzha,9.542602965599087,76.38010796263319,598,2127789,1013142,1114647,1852797,890552,962245,1460447,224545,435056,268,146,74,311,6942,723536,133039,334339,418953,573306,274789,198858,58096,1991380,163991,2155371,891512,648522,585591,2164,3368,110,87
Kerala,Ernakulam,10.004879301987431,76.26957729035381,595,3282388,1619557,1662831,2855676,1425723,1429953,1509557,514397,1248137,860,614,1176,1083,6564,1174691,212263,446380,554817,702511,389793,429880,113133,2848777,268315,3117092,1396968,1024720,858010,2690,6274,102,86
Kerala,Idukki,9.80480963855423,77.04586641566264,596,1108974,552808,556166,923010,471881,451129,541854,82206,481507,100,189,44,384,2690,412433,79149,166604,209398,261237,136428,86136,19252,958204,126589,1084793,494456,352163,261471,884,1374,100,83
Kerala,Kannur,11.941523076923056,75.35209891725934,589,2523003,1181446,1341557,2138434,1012956,1125478,1509592,742483,262526,424,1118,193,722,5945,872479,204713,487016,491844,540383,308670,217203,40277,2290106,279352,2569458,1187177,741984,588081,5761,4432,113,84
Kerala,Kasaragod,12.33310309912974,75.07768497134369,588,1307375,628613,678762,1037492,516476,521016,729987,486913,87454,151,362,130,152,2226,417805,115476,268084,230416,238900,122657,76192,16585,1068310,212905,1281215,688763,369883,246975,1754,1988,107,79
Kerala,Kollam,8.929388820570157,76.6360775852431,600,2635375,1246968,1388407,2240273,1074345,1165928,1697635,508500,421598,208,272,63,619,6480,925130,172247,406592,562529,595191,307950,233402,64052,2341963,231286,2573249,1177359,795245,660965,1806,3910,111,85
Kerala,Kottayam,9.643701174068417,76.46059673302705,597,1974551,968289,1006262,1749798,861592,888206,983598,126499,858608,204,358,83,565,4636,678161,117681,271496,373998,475724,280720,221350,52339,1793308,134393,1927701,811653,596302,565048,1548,3071,103,88
Kerala,Kozhikode,11.392924270557026,75.71158720159153,591,3086293,1470942,1615351,2615443,1266939,1348504,1734958,1211131,131516,297,235,601,588,6967,990336,247996,564392,647221,630818,351267,250117,53166,2744977,335520,3080497,1487644,909581,686109,2959,4594,109,84
Kerala,Malappuram,10.97329875666072,75.93910775606876,592,4112920,1960328,2152592,3311315,1597404,1713911,1135259,2888849,81556,205,179,68,579,6225,1157129,415601,770417,814285,933793,392867,203779,41344,3572086,622345,4194431,2406005,1041361,662311,3243,4838,109,80
Kerala,Palakkad,10.784926903553291,76.49980490693744,593,2809934,1359478,1450456,2239492,1122600,1116892,1875980,812936,114397,220,238,78,400,5685,894341,249198,492864,608176,572412,232109,180540,36370,2371669,439934,2811603,1395222,802611,608966,3135,3929,106,79
Kerala,Thiruvananthapuram,8.537101759082221,76.88711502868073,601,3301427,1581678,1719749,2785408,1354857,1430551,2194057,452915,630573,404,301,76,1082,22019,1169117,206328,460690,642470,682156,389161,381782,76129,2838716,309042,3147758,1488441,989238,820024,3724,5770,108,84
Kerala,Thrissur,10.458932647907687,76.12321940836945,594,3121200,1480763,1640437,2678548,1282261,1396287,1823442,532839,757484,259,278,62,585,6251,1051867,222627,445696,524387,821831,362657,338600,71535,2787333,307665,3094998,1394214,931841,792182,2963,5612,110,85
Kerala,Wayanad,11.715277464788736,76.07587007042254,590,817420,401684,415736,645585,328136,317449,404460,234185,174453,61,312,1797,286,1866,277988,65326,144896,137227,184266,87042,51111,8786,678654,131211,809865,412806,246590,157326,698,1095,103,78
Madhya Pradesh,Anuppur,23.18184220430107,81.86560000000007,461,749237,379114,370123,436595,254120,182475,686524,21473,2132,606,86,1653,35434,1329,207713,113208,115716,93450,58536,42743,31646,3066,458365,271733,730098,444954,193520,109813,950,787,97,58
Madhya Pradesh,Ashoknagar,24.63098846153845,77.82974493927134,459,845071,443837,401234,469109,290304,178805,778214,40707,635,8009,1352,15094,27,1033,206741,148647,117053,62802,51499,29551,22791,3466,435809,359525,795334,535410,194772,114131,758,861,90,55
Madhya Pradesh,Balaghat,21.80020720640569,80.42170053380796,457,1701698,842178,859520,1147623,626468,521155,1519384,38542,5295,1050,72162,4778,58064,2423,470867,290699,312640,235251,168635,126308,74213,7414,1215160,493415,1708575,969773,453605,276799,1521,1709,102,67
Madhya Pradesh,Barwani,21.702135714285724,74.91004719710673,441,1385881,699340,686541,549926,313642,236284,1318869,58222,2967,2361,416,2289,263,494,299270,157337,137116,74067,59100,42649,30754,2581,503604,825034,1328638,923665,302833,158594,789,1336,98,39
Madhya Pradesh,Betul,21.964626315789477,77.7873428189117,447,1575362,799236,776126,939769,529783,409986,1505745,37590,3271,1078,9651,3759,13048,1220,406649,239114,232532,176325,140402,105696,82761,5876,982706,603098,1585804,938819,392728,242592,1223,1845,97,59
Madhya Pradesh,Bhind,26.35951126187245,78.7618324287653,420,1703005,926843,776162,1094917,676513,418404,1595400,66776,973,4047,12215,19950,73,3571,359596,202629,261162,199044,140743,96011,50222,8059,957870,388473,1346343,1040736,399676,258588,4005,1786,83,64
Madhya Pradesh,Bhopal,23.480726143790854,77.39246623093679,444,2371061,1236130,1134931,1660690,920314,740376,1755861,525434,23432,10789,21688,25950,335,7572,700719,229082,303171,287198,211371,178165,266618,30845,1506450,462581,1969031,1405814,625594,330291,9362,4298,91,70
Madhya Pradesh,Burhanpur,21.364567254408065,76.24460478589425,467,757847,388504,369343,408679,233073,175606,552526,180840,1199,1074,19883,1884,99,342,178840,107547,119468,69765,57058,42618,28237,4761,429454,317962,747416,469838,181605,106034,370,989,95,53
Madhya Pradesh,Chhatarpur,24.813637376460004,79.56449299191374,425,1762375,936121,826254,943033,572010,371023,1676918,70351,1980,968,250,10409,102,1397,470917,270951,236054,160310,112961,77787,59704,7837,925604,770268,1695872,1112636,394060,252417,3262,1947,88,53
Madhya Pradesh,Chhindwara,22.227966971713823,78.76413136439254,455,2090922,1064468,1026454,1294198,731294,562904,1923920,100692,4893,2258,24471,7830,25771,1087,553944,284113,336391,225747,215098,167946,112383,12141,1353819,663446,2017265,1232263,535316,321977,1366,2513,96,61
Madhya Pradesh,Damoh,23.76624407960196,79.47049303482588,428,1264219,661873,602346,747715,445737,301978,1186420,47966,1681,1096,119,25005,82,1850,369901,197917,217296,150040,95032,64414,41158,5260,771117,469038,1240155,768929,312593,181403,1294,1359,91,59
Madhya Pradesh,Datia,25.90226439560441,78.63916571428574,422,786754,420157,366597,491445,303815,187630,747693,28483,683,490,7923,453,10,1019,203854,132176,131372,88949,73398,48978,34853,4262,513988,260076,774064,473097,195131,118186,340,951,87,62
Madhya Pradesh,Dewas,22.7851110021322,76.46088805970157,437,1563715,805359,758356,925369,550716,374653,1376591,174259,2355,2330,382,6497,72,1229,376009,242508,225380,149522,125772,94403,55383,4991,897959,565365,1463324,943954,388648,230280,833,1899,94,59
Madhya Pradesh,Dhar,22.572681718963157,75.1105620736698,438,2185793,1112725,1073068,1077338,638479,438859,2051219,116202,2261,1607,328,12199,88,1889,515712,262090,244058,164576,134279,99882,66721,6543,978149,1021851,2000000,1377326,533243,273050,2174,2470,96,49
Madhya Pradesh,Dindori,22.83738437047757,81.04332966714911,453,704524,351913,352611,378714,222759,155955,605435,6736,4238,260,61,687,84006,3101,227795,103002,113875,84065,49277,31104,15179,1674,398176,295655,693831,419531,181841,102522,630,652,100,53
Madhya Pradesh,Guna,24.49043927178156,77.2235895968791,458,1241519,649362,592157,653980,400537,253443,1172248,49203,1208,3271,529,13474,52,1534,285085,197902,157141,84560,79924,50724,42147,6451,618849,578034,1196883,793150,285176,162104,1089,1302,91,52
Madhya Pradesh,Gwalior,26.04074441964285,78.12782433035713,421,2032036,1090327,941709,1357210,803114,554096,1835299,141735,4119,24790,4361,18058,217,3457,444892,235648,235924,204871,193082,166719,193947,23148,1253339,554486,1807825,1218319,519728,291451,2538,2830,86,66
Madhya Pradesh,Harda,22.227659781121783,77.07022571819435,448,570465,294838,275627,352550,203807,148743,527462,38640,683,676,93,1573,55,1283,144559,90059,87733,60757,46556,31939,27126,3469,347639,177731,525370,347774,138882,83417,392,619,93,61
Madhya Pradesh,Hoshangabad,22.595268801996703,78.02168094841929,449,1241350,648725,592625,810644,469199,341445,1175203,52269,4453,3127,1550,3888,107,753,315396,159703,183156,145076,119682,89589,84769,9279,791254,344492,1135746,730768,318232,191501,849,1535,91,65
Madhya Pradesh,Indore,22.680265752128648,75.9133801324502,439,3276697,1699627,1577070,2309130,1289631,1019499,2728225,415142,18523,25696,11496,71667,720,5228,788318,428413,472233,384611,362209,300076,382658,36326,2366526,718174,3084700,1877270,894464,493096,11867,5783,92,70
Madhya Pradesh,Jabalpur,23.18525572327043,79.98328754716981,451,2463289,1277278,1186011,1756468,980307,776161,2159065,203652,23142,13256,4320,33728,21010,5116,624761,267932,352284,313910,268333,222987,235072,24872,1685390,540029,2225419,1387369,679185,391903,4832,3776,92,71
Madhya Pradesh,Jhabua,22.419578015397768,74.40921616766468,464,1025048,515023,510025,352081,214582,137499,960925,15733,38423,141,65,8871,388,502,235793,98308,79781,40466,38236,28990,20240,1973,307994,775664,1083658,684200,220769,119681,398,1612,99,34
Madhya Pradesh,Katni,23.724416229116937,80.33819665871127,450,1292042,662013,630029,790773,460583,330190,1240650,37232,3158,1167,157,5342,2643,1693,349031,198447,207366,161727,112242,80935,53578,6658,820953,465374,1286327,778414,326582,185857,1189,1476,95,61
Madhya Pradesh,Mandla,22.70348712446353,80.38600543633753,454,1054905,525272,529633,604962,348033,256929,849518,16558,12450,436,297,1789,170533,3324,316932,156711,170994,115632,82166,58066,35476,4587,623632,376944,1000576,614794,278553,160510,1048,1043,100,57
Madhya Pradesh,Mandsaur,24.19278764044944,75.43588667736759,433,1340411,682851,657560,834591,502898,331693,1192588,125548,1120,849,242,19029,77,958,384119,244891,217234,149219,109751,77219,52546,4956,855816,467002,1322818,781000,346861,211815,735,1475,96,62
Madhya Pradesh,Morena,26.37313504531724,77.88447341389724,419,1965970,1068417,897553,1179685,747652,432033,1875495,76159,1092,557,3234,6681,92,2660,414586,288979,285682,228234,170254,115790,71005,8265,1168209,706917,1875126,1254302,452484,257704,1480,1924,84,60
Madhya Pradesh,Neemuch,24.70311893333336,75.06608186666664,432,826067,422653,403414,508834,307889,200945,741288,67324,1508,1110,224,14165,115,333,242197,137656,127167,83189,69134,53465,42343,6119,519073,289113,808186,476995,217403,131227,442,1026,95,61
Madhya Pradesh,Panna,24.451325840092657,80.21133001158752,426,1016520,533480,483040,552559,332140,220419,974748,35214,418,186,37,4734,218,965,288923,171707,134936,99251,70359,47903,29795,3052,557003,427997,985000,635347,235035,144827,1311,1034,90,54
Madhya Pradesh,Raisen,23.292518206521724,78.16305495923909,446,1331597,700358,631239,820220,479093,341127,1195235,120331,1725,2262,253,10637,190,964,325713,237981,210402,144108,117908,69419,48384,4607,832809,444877,1277686,832939,316319,181524,815,1460,90,61
Madhya Pradesh,Rajgarh,23.785499026425583,76.66431223922116,442,1545814,790212,755602,804245,488797,315448,1433879,106928,1243,460,121,1599,50,1534,401717,239738,174381,103464,96386,72316,51499,4799,742583,706958,1449541,935230,363218,246447,919,1629,95,52
Madhya Pradesh,Ratlam,23.503562290502792,75.14895782122909,434,1455069,738241,716828,825880,485090,340790,1267043,151071,3996,1353,175,29353,123,1955,373867,224715,194131,129392,111461,86507,67192,5868,819266,622153,1441419,876905,363858,213560,746,1700,97,56
Madhya Pradesh,Rewa,24.861184625158856,81.57572465057183,430,2365106,1225100,1140006,1441757,845572,596185,2268838,85414,1964,832,986,655,232,6185,618399,344362,330131,312931,206274,180635,122371,11438,1508142,766166,2274308,1460075,540235,362228,2568,2756,93,60
Madhya Pradesh,Sagar,23.800318709677374,78.71940357771273,427,2378458,1256257,1122201,1545719,908607,637112,2198297,103480,5580,4146,991,62992,168,2804,613915,347752,426916,297079,214137,137899,116753,14346,1554882,711804,2266686,1470688,569166,335432,3172,2771,89,64
Madhya Pradesh,Satna,24.62777621776502,80.75547048710598,429,2228935,1157495,1071440,1371781,801051,570730,2158623,59471,2228,1163,364,3135,1689,2262,576004,338947,334635,309536,197373,148091,105499,16052,1450133,715509,2165642,1365647,535086,326049,2153,2641,92,61
Madhya Pradesh,Sehore,22.9297199679658,77.06780202883085,445,1311332,683743,627589,780362,469208,311154,1163607,137980,1404,640,357,6232,66,1046,329647,193885,179388,136284,120687,77541,50655,6755,765195,508396,1273591,817608,305605,187611,508,1442,91,59
Madhya Pradesh,Seoni,22.33230487804874,79.66053863928111,456,1379131,695879,683252,864194,485341,378853,1145052,79739,1857,360,7288,4982,135315,4538,382587,223650,241327,151636,116124,84398,55984,6427,879546,458811,1338357,809922,363037,205237,935,1369,98,62
Madhya Pradesh,Shahdol,23.44859864559819,81.4596831828442,460,1066063,540021,526042,604194,348761,255433,997073,42426,2372,912,268,1737,19448,1827,291440,161972,154282,128427,80402,60915,46513,5352,637863,422736,1060599,645619,269145,150655,644,1302,97,56
Madhya Pradesh,Shajapur,23.566620317220547,76.33555181268885,436,1512681,780520,732161,894612,543509,351103,1321003,174724,815,631,179,13755,66,1508,386608,271215,239081,141225,111366,75967,48671,3391,890916,544791,1435707,901161,369741,240768,1011,1647,93,59
Madhya Pradesh,Sheopur,25.78014810996563,77.16911116838484,418,687861,361784,326077,328025,208201,119824,638702,41396,230,6387,201,379,40,526,176522,90911,70840,43009,37072,24732,17091,1497,285152,393141,678293,449974,155063,82416,408,693,90,47
Madhya Pradesh,Shivpuri,25.37802451874367,77.74861600810549,423,1726050,919795,806255,900846,573242,327604,1648749,51200,1117,7151,3421,12171,72,2169,434618,261087,214162,125117,84684,58509,44812,6218,794589,719547,1514136,1106084,389652,227989,2325,1827,87,52
Madhya Pradesh,Sidhi,24.17547189952905,82.1053783359498,462,1127033,575912,551121,600785,353030,247755,1077545,34419,511,128,92,93,12556,1689,276869,185550,168224,129344,80312,60845,33067,3896,661238,477472,1138710,721531,253685,150959,858,3019,95,53
Madhya Pradesh,Tikamgarh,25.14099852104666,78.89357064846428,424,1445166,760355,684811,747940,459353,288587,1383475,44143,588,251,109,15569,39,992,382992,202448,188694,143231,78053,58245,35034,5340,711045,659348,1370393,898323,343824,201875,1144,1591,90,51
Madhya Pradesh,Ujjain,23.319288862745065,75.80383717647058,435,1986864,1016289,970575,1240990,730817,510173,1718204,233133,4659,3241,945,24622,211,1849,489449,286534,280030,178295,159263,119586,111290,13282,1148280,659279,1807559,1156749,508302,320502,1311,2599,95,62
Madhya Pradesh,Umaria,23.59601063063061,80.90879477477475,431,644758,330674,314084,356672,210907,145765,620515,15966,667,190,70,220,6028,1102,168066,90791,94011,74854,43418,27216,18144,2784,351218,230782,582000,403030,158140,82984,604,692,94,55
Madhya Pradesh,Vidisha,23.82838307984792,77.9013507604563,443,1458875,769568,689307,862918,512344,350574,1287391,149548,1313,914,295,18490,70,854,376409,242021,214603,123650,104007,65581,59814,6780,816456,512311,1328767,919239,335690,203005,941,1583,89,59
Maharashtra,Akola,20.746310479041902,77.12122320359276,501,1813906,932334,881572,1411281,758977,652304,1107809,357253,4483,1504,328033,10205,389,4230,504235,231841,328367,275264,291391,205723,112574,15157,1460317,352687,1813004,998769,483200,327932,4005,3948,94,77
Maharashtra,Amravati,21.16520991810736,77.67583503184723,503,2888445,1480768,1407677,2251875,1207104,1044771,2055177,421410,7223,2242,383891,11360,3288,3854,781815,326195,468853,463051,525116,346876,203273,16148,2349512,478074,2827586,1540590,783549,553265,11041,6236,95,77
Maharashtra,Aurangabad,20.0979228832952,75.32072196796334,235,2540073,1318684,1221389,1466002,868733,597269,2291133,237353,2218,295,334,775,19,7946,477297,559512,482199,302662,253142,136783,91371,8329,1833998,784131,2618129,1626969,564571,340948,7585,2215,92,57
Maharashtra,Aurangabad,20.0979228832952,75.32072196796334,515,3701282,1924469,1776813,2503837,1430936,1072901,2545438,786677,15991,5142,309093,30981,1005,6955,979132,381695,686271,422964,537936,310762,253253,19101,2611982,819734,3431716,2211996,909771,571932,7583,8119,92,67
Maharashtra,Bhandara,21.211792649727748,80.10950199637024,506,1200334,605520,594814,899860,488709,411151,1009352,26502,2145,831,154458,1017,3555,2474,356418,115150,187870,208902,204435,153749,67061,12452,949619,235524,1185143,626978,333120,232754,7482,2237,98,74
Maharashtra,Bid,18.952353340080982,75.69319706477731,523,2585049,1349106,1235943,1718507,987185,731322,2174672,320395,2097,824,68482,8719,399,9461,698571,309704,436446,280800,316758,206530,129996,11438,1691672,821607,2513279,1473882,614615,494436,2116,4179,91,66
Maharashtra,Buldana,20.56680611183355,76.39017880364096,500,2586258,1337560,1248698,1879874,1048892,830982,1845424,354236,3531,1668,364229,12242,522,4406,728192,315408,457067,400342,406379,228266,113783,19619,1940864,600436,2541300,1467457,641840,473071,3890,4421,93,72
Maharashtra,Chandrapur,20.095609090909075,79.31556380471388,509,2204307,1123834,1080473,1578615,872565,706050,1780085,92297,10701,5251,286734,3861,23188,2190,684655,243773,316192,337320,351610,241179,126488,15040,1631602,516728,2148330,1163802,629890,403719,6896,5085,96,71
Maharashtra,Dhule,21.274018690400517,74.58719071837263,498,2050862,1054031,996831,1293916,723388,570528,1825460,187901,3653,1422,13405,12818,912,5291,528790,200494,323641,208571,290656,182739,114931,14526,1335558,649568,1985126,1167569,513908,350747,18638,3583,94,63
Maharashtra,Gondiya,21.225008411214997,80.17522698598128,507,1322507,661554,660953,1004243,542837,461406,1153861,26157,1827,2160,125282,1568,5080,6572,386515,138457,237888,231153,225595,159570,57923,9620,1060206,256549,1316755,704214,371908,244111,2274,2183,99,75
Maharashtra,Hingoli,19.59525302245251,77.09239412780653,512,1177345,606294,571051,790743,450551,340192,863199,127552,992,643,176679,5278,103,2899,284369,175736,266649,127246,136075,74544,38698,5932,824880,331388,1156268,692117,281905,201828,1495,1853,94,67
Maharashtra,Jalgaon,20.8828943415638,75.55140421810695,499,4229917,2197365,2032552,2891882,1629223,1262659,3457615,560261,7091,3091,143865,27404,9662,20928,1169788,482462,735730,532587,627198,375643,229987,31008,3014615,1003050,4017665,2352671,1080237,763529,33480,7988,92,68
Maharashtra,Jalna,19.984612534818933,75.98473607242339,514,1959046,1011473,947573,1195523,699428,496095,1504641,274221,12542,1629,152540,9619,336,3518,502830,271061,422207,218189,225331,120715,64060,9724,1331287,545980,1877267,1150104,454836,341479,12627,3363,93,61
Maharashtra,Kolhapur,16.44881301587301,74.12897150793648,530,3876001,1980658,1895343,2825845,1559760,1266085,3379906,286558,15573,1570,29766,154882,1274,6472,1179314,321457,622362,487227,698604,395234,335413,40828,2901125,778000,3679125,1972486,1084858,801590,17067,8464,95,72
Maharashtra,Latur,18.348687268993856,76.75812607802874,524,2454196,1273140,1181056,1650672,932432,718240,2006984,367664,2387,935,66535,6387,310,2994,585632,268627,423711,296910,380344,224998,153256,18106,1765952,596213,2362165,1406364,584243,453229,10360,4574,92,67
Maharashtra,Nagpur,21.196556862745105,79.02166176470584,505,4653570,2384975,2268595,3673808,1959220,1714588,3492202,390974,34667,20469,668050,24528,12181,10499,1308366,325084,666693,812381,790443,542228,493236,73475,3703540,601547,4305087,2460820,1361821,818467,12462,14073,95,78
Maharashtra,Nanded,19.209316983017,77.6829048951049,511,3361292,1730075,1631217,2189425,1255222,934203,2501741,471951,3902,13540,354189,5049,1273,9647,821682,416869,691348,368723,416761,255650,156225,21729,2327305,884626,3211931,2008314,809135,535827,8016,6214,94,65
Maharashtra,Nandurbar,21.523175625248147,74.32638757443429,497,1648295,833170,815125,906509,512099,394410,1521618,96182,8467,685,4969,6191,2907,7276,405012,166664,218718,121404,160961,113019,58461,9248,848475,790613,1639088,1011352,390419,241534,4990,2446,97,54
Maharashtra,Nashik,20.266912871287143,74.03824168316828,516,6107187,3157186,2950001,4345366,2397538,1947828,5237009,693052,23946,8912,94783,38212,1795,9478,1668932,544346,1038955,851714,830070,485052,373100,97219,4220456,1481778,5702234,3580633,1567252,948469,10833,13629,93,71
Maharashtra,Osmanabad,18.19459456066944,75.99495575313809,525,1657576,861535,796041,1137810,644304,493506,1437623,178925,942,340,28216,4530,195,6805,444990,183972,300965,201646,260772,139479,96847,9913,1193594,440363,1633957,917343,393539,343021,3673,2786,92,68
Maharashtra,Parbhani,19.31032425249168,76.70163338870431,513,1836086,942870,893216,1157814,666291,491523,1328385,306364,2081,1371,187899,6238,262,3486,427239,229217,396713,204316,229103,116041,81333,9703,1266426,552643,1819069,1078349,436486,313455,7796,3410,94,63
Maharashtra,Pune,18.51696171428573,74.12922881632647,521,9429408,4924105,4505303,7171723,3940210,3231513,8090254,673704,134192,27090,340404,127786,9873,26105,3222457,559840,1234549,1383055,1414563,867256,1086650,190336,6736249,1353077,8089326,5184734,2624165,1586132,34377,27223,91,76
Maharashtra,Raigarh,18.453257637845976,73.0090609418579,403,1493984,750278,743706,951639,542756,408883,1422986,17332,47653,2117,781,409,1782,924,420916,246480,260661,210964,130700,93340,66358,8804,1017307,460166,1477473,841958,398257,253488,281,1575,99,63
Maharashtra,Raigarh,18.453257637845976,73.0090609418579,520,2634200,1344345,1289855,1939994,1059692,880302,2239370,227465,17452,7477,121791,12260,1159,7226,959028,231263,407662,335886,441072,221410,204507,19940,1861740,482420,2344160,1414154,748339,462741,8966,6097,95,73
Maharashtra,Ratnagiri,17.210195070127703,73.25725893866404,528,1615069,761121,853948,1199392,619012,580380,1307211,187197,1990,230,113467,3347,95,1532,639362,163025,378554,269872,247257,111600,65700,15429,1251437,319622,1571059,777431,438905,396967,1766,3484,112,74
Maharashtra,Sangli,17.154930181086502,74.70713822937628,531,2822143,1435728,1386415,2049467,1121550,927917,2440312,239607,9098,1260,38210,87453,769,5434,853673,208511,507318,459156,453404,244804,214003,36983,2124179,579039,2703218,1450907,752303,603739,15194,5798,96,72
Maharashtra,Satara,17.6737908974359,74.18052064102558,527,3003741,1510842,1492899,2225694,1201034,1024660,2691952,146970,4408,1182,141315,12810,676,4428,975471,288427,495822,407977,556706,299993,243457,20884,2313266,545423,2858689,1517324,800492,671702,14223,5649,98,74
Maharashtra,Sindhudurg,16.170948049777163,73.51329008172343,529,849651,417332,432319,666067,348289,317778,780384,26264,15471,219,24762,1046,53,1452,340836,86480,165284,134734,175070,89023,48418,3451,702460,121922,824382,382024,242296,222963,2368,1749,103,78
Maharashtra,Solapur,17.837357937584812,75.42394823609216,526,4317756,2227852,2089904,2910676,1651266,1259410,3795424,441254,9882,1279,35497,28134,568,5718,1156231,390337,788150,535848,643327,328020,236302,29051,2951035,976795,3927830,2402794,1089900,809935,15127,8995,93,67
Maharashtra,Thane,19.698767747440264,72.79882742564581,517,11060148,5865078,5195070,8227161,4591396,3635765,8716055,1355630,280700,39149,449617,172052,9862,37083,3618151,712171,1530916,1588196,1751284,1080597,961719,114453,7739336,1692022,9431358,6184519,3241888,1579921,53820,35118,88,74
Maharashtra,Wardha,20.80743024390242,78.57259105691062,504,1300774,668385,632389,1019458,552617,466841,1057096,53854,2696,2147,175417,5663,2254,1647,388704,140470,186781,201471,225208,158055,93772,7017,1012774,212054,1224828,659540,370227,270107,900,2754,94,78
Maharashtra,Washim,20.282282394366213,77.25502394366208,502,1197160,620302,576858,869917,487703,382214,859949,142672,1707,518,179330,8476,381,4127,330846,166509,238985,160331,162762,116032,47865,7294,899778,291525,1191303,682919,302425,210185,1631,1942,92,72
Maharashtra,Yavatmal,20.04258346738159,78.05326371760479,510,2772348,1419965,1352383,2022574,1115980,906594,2251401,239236,4567,1596,249874,11422,3745,10507,798132,391944,562739,382001,389924,245819,123074,21889,2117390,718204,2835594,1549263,733258,483813,6014,4937,95,72
Manipur,Bishnupur,24.50712111801243,93.8246236024845,275,237399,118782,118617,156333,87313,69020,175102,18691,4264,56,76,16,38457,737,56149,15941,36011,50004,31775,20077,20074,1440,175322,67610,242932,135220,62907,38815,457,226,99,65
Manipur,Chandel,24.2635812987013,94.09443844155844,280,144182,74579,69603,90302,51053,39249,10810,3086,129049,136,400,59,354,288,34160,17382,28163,30589,18971,12213,8105,240,115663,38191,153854,86255,39324,18329,274,250,93,62
Manipur,Churachandpur,24.30309718875504,93.38671506024085,274,274143,138820,135323,195935,104013,91922,12034,2886,254979,152,495,87,2333,1177,57825,32860,67907,65475,38567,23284,14523,509,243125,57561,300686,168608,67802,37096,637,327,97,71
Manipur,Senapati,25.08465586034914,94.03366234413956,272,479148,247323,231825,264477,148012,116465,43833,1649,426819,140,2409,53,1243,3002,39834,46757,81735,91395,62033,40438,24940,598,347896,191001,538897,314439,111516,52008,1185,823,93,55
Manipur,Tamenglong,24.98312942238265,93.49450740072204,273,140651,72371,68280,85006,47403,37603,2995,589,134760,59,425,57,1144,622,28101,11155,28461,26794,17867,11645,7102,270,103294,45317,148611,90273,33290,16924,164,90,94,60
Manipur,Thoubal,24.545392553191498,93.97959893617023,276,422168,210845,211323,269304,152617,116687,267146,107323,4322,106,114,24,42347,786,104263,32396,69738,87932,55803,37899,28550,3214,315532,118088,433620,251975,107196,62060,937,539,100,63
Manipur,Ukhrul,25.05900314960629,94.44129566929138,279,183998,94718,89280,129829,70148,59681,7553,1115,174112,108,635,70,32,373,41890,20670,29382,38350,31734,22729,15636,405,158906,42156,201062,113715,43646,25165,1472,79,94,70
Meghalaya,East Garo Hills,25.82728228228228,90.64684924924916,294,317917,161223,156694,192147,102513,89634,17272,3359,289708,56,1004,38,5617,863,74216,51578,70679,52762,31328,9473,2484,298,218602,100781,319383,216742,70424,29926,825,450,97,60
Meghalaya,East Khasi Hills,25.303763888888884,91.75922519841272,298,825922,410749,415173,578030,287270,290760,144935,14185,543394,2495,3111,303,115597,1902,215091,118135,163729,127722,94579,58836,61639,9397,634037,168575,802612,545961,192428,86576,957,1456,101,69
Meghalaya,Jaintia Hills,25.33959557069844,92.37608160136298,299,395124,196285,198839,187527,87371,100156,12456,1646,271596,34,284,45,107559,1504,83717,67749,61526,34677,26748,13544,8039,2934,215217,165184,380401,291097,72934,30362,731,528,101,47
Meghalaya,South Garo Hills,25.240568578553614,90.64560349127176,295,142334,73170,69164,82062,45003,37059,7036,1050,132984,27,332,10,362,533,39643,25906,28921,21506,13858,3998,826,831,95846,44849,140695,97082,30605,14495,152,139,94,57
Meghalaya,West Garo Hills,25.495285185185185,90.03709947089942,293,643291,324159,319132,358702,193438,165264,122936,106788,389956,209,3392,144,16950,2916,157945,85733,129178,90963,70941,29404,10856,3547,420622,208900,629522,427629,143604,70599,1459,791,98,55
Meghalaya,West Khasi Hills,25.500889926739926,91.25364542124538,296,383461,193715,189746,230678,117307,113371,6498,1533,366881,58,1313,38,5878,1262,87131,80318,78208,45046,28417,12295,6450,541,251275,133244,384519,278569,69988,33431,1473,479,97,60
Mizoram,Aizawl,23.90781335453101,92.85359459459472,283,400309,199270,201039,340595,169547,171048,13249,5264,379134,105,1570,76,505,406,100911,29332,68214,100103,78752,37701,31310,2058,347470,38248,385718,235892,108094,56092,231,963,100,85
Mizoram,Champhai,23.54166580976866,93.24221799485862,284,125745,63388,62357,100802,51440,49362,1075,699,123446,9,151,45,194,126,31112,14491,31359,30454,16259,4956,4087,78,101684,15449,117133,78778,29690,17189,88,187,98,80
Mizoram,Kolasib,24.2020004347826,92.73470391304348,282,83955,42918,41037,65895,34147,31748,4000,4426,75210,16,108,2,46,147,22176,11367,18046,20399,9849,3473,2530,62,65726,14217,79943,52147,20576,11167,65,142,95,78
Mizoram,Lawngtlai,22.36102843137253,92.66964156862753,287,117894,60599,57295,62861,36444,26417,1668,522,63892,52,51549,122,2,87,27266,19890,21114,16629,10538,3763,2515,125,74574,54874,129448,80723,25303,11831,37,242,94,53
Mizoram,Lunglei,23.007717036172675,92.63512555425892,286,161428,82891,78537,121122,64515,56607,5231,1290,127124,74,27543,93,5,68,38794,22181,33313,34774,19918,8503,5509,116,124314,32451,156765,100250,39690,21424,64,274,94,75
Mizoram,Mamit,23.73852942502819,92.4330803833147,281,86364,44828,41536,60191,32977,27214,2989,1782,69104,13,12328,25,19,104,20855,9328,19711,19949,10756,3180,1771,22,64717,20091,84808,55914,20082,10318,50,94,92,69
Mizoram,Saiha,22.35744801061008,93.02827931034489,288,56574,28594,27980,42233,21861,20372,933,514,54977,11,102,4,2,31,12827,8422,14151,12130,7269,3628,2204,69,47873,8787,56660,37127,12784,6636,27,88,97,74
Mizoram,Serchhip,23.263864705882344,92.914158496732,285,64937,32851,32086,54476,27598,26878,991,335,63444,6,60,9,35,57,15490,8771,14985,16237,9062,2915,2128,35,54133,5963,60096,39568,15894,9404,71,118,97,83
Nagaland,Dimapur,25.814176811594223,93.75074057971014,265,378811,197394,181417,278037,150142,127895,108900,31212,234239,566,1270,2148,157,319,111969,34539,61815,80076,44343,26712,27532,2939,277956,58926,336882,243392,98601,36618,200,866,91,73
Nagaland,Kohima,25.60311428571428,93.78600657596373,270,267988,138966,129022,197489,107038,90451,25496,4384,234955,998,1519,80,335,221,76100,21654,46756,57726,30518,19855,23439,1770,201718,45802,247520,173701,68485,25557,245,677,92,73
Nagaland,Mokokchung,26.478911764705888,94.522426006192,262,194622,101092,93530,159494,83479,76015,9840,2057,181847,78,442,66,6,286,55278,20259,43483,54035,27425,13077,10299,870,169448,22555,192003,111243,52853,30363,163,346,92,81
Nagaland,Mon,26.69207374301676,95.03072988826828,261,250260,131753,118507,119626,67432,52194,8102,3444,236494,84,1256,314,1,565,51022,37431,46055,30500,7628,3565,1772,107,127058,130529,257587,168773,53600,27437,450,381,89,47
Nagaland,Phek,25.63272986577182,94.56814563758392,266,163418,83743,79675,105893,57926,47967,3563,950,158224,31,350,17,198,85,46198,22494,32722,30434,12785,7268,5926,481,112110,44456,156566,108514,37842,16969,93,219,95,64
Nagaland,Tuensang,26.21104453280316,94.85809880715708,267,196596,101933,94663,117511,63653,53858,2979,1052,191864,27,572,5,1,96,50141,29602,40900,33514,15013,6008,2760,116,127913,66450,194363,134573,43210,18762,51,228,92,59
Nagaland,Wokha,26.202611551155112,94.1990815181518,264,166343,84505,81838,128208,67385,60823,5605,2043,158236,34,318,8,20,79,46669,15865,37024,41627,18746,10223,8030,401,131916,25048,156964,106951,40510,18811,71,359,96,77
Nagaland,Zunheboto,26.028178205128206,94.50026666666668,263,140757,71217,69540,102881,53504,49377,2580,772,136995,39,286,6,2,77,37311,16523,30889,35113,17282,8821,5560,1107,115295,25988,141283,91709,32267,16730,51,275,97,73
Orissa,Baleshwar,21.48570932311624,87.08085828011933,377,2320529,1185787,1134742,1621232,902359,718873,2197709,94254,6434,237,111,201,18345,3238,683594,342192,470502,416510,267354,112392,105962,27493,1742405,628627,2371032,1303828,622575,390611,3515,2664,95,69
Orissa,Bhadrak,20.95262735257214,86.81496204516931,378,1506337,760260,746077,1094140,596269,497871,1398543,104202,745,169,81,111,61,2425,428106,210736,391081,297270,177013,71815,67536,17449,1232900,323145,1556045,848660,393629,260486,3562,1711,98,72
Orissa,Cuttack,20.407640646029623,85.7776810228802,381,2624470,1352760,1271710,2011469,1103033,908436,2457729,141263,11985,1026,6276,1180,168,4843,790297,289414,545514,513039,328319,159456,181601,45279,2062622,472182,2534804,1372301,743090,499895,9184,3852,94,76
Orissa,Dhenkanal,20.79887159353349,85.53226836027711,383,1192811,612593,580218,829910,464093,365817,1185542,4805,727,124,366,39,139,1069,352369,188872,238599,193395,132002,53162,43064,10903,859997,341887,1201884,641697,326233,222398,2483,1334,94,69
Orissa,Gajapati,19.121080882352945,84.14015091911759,389,577817,282882,294935,262537,153663,108874,353160,1556,219482,53,2180,66,4,1316,175145,68405,76419,54787,36977,17084,12556,1882,268110,335821,603931,345387,144043,85072,3315,617,104,45
Orissa,Ganjam,19.2632617564534,84.80297710437702,388,3529031,1779218,1749813,2210050,1262652,947398,3486059,13315,23975,590,174,170,76,4672,1015394,518072,767140,508511,297490,121151,97147,31266,2340777,1055331,3396108,1980232,924756,613249,10794,4377,98,62
Orissa,Jharsuguda,21.827058566978184,83.93581682242987,371,579505,296690,282815,405879,228092,177787,553587,12783,10462,1441,80,70,67,1015,177186,69122,101541,103622,70928,32909,22010,7932,408064,143508,551572,320156,159477,98555,1317,870,95,70
Orissa,Kalahandi,19.784253092783523,83.1124043814433,395,1576869,787101,789768,802036,484177,317859,1555367,4975,11160,796,175,1225,220,2951,494748,213426,225468,172905,94044,40383,27385,6840,780451,765368,1545819,880160,415778,275533,5398,1562,100,50
Orissa,Kandhamal,20.092878624813142,84.02216352765326,390,733110,359945,373165,399786,233900,165886,580300,2138,148895,82,290,47,23,1335,242935,108606,145604,108773,48856,21351,14962,2462,450614,287948,738562,436625,177471,117777,1237,739,103,54
Orissa,Kendrapara,20.606319815982264,86.83763247572003,379,1440361,717814,722547,1089265,579970,509295,1386792,50247,1423,169,62,52,24,1592,438243,218444,357621,298557,203472,76449,75926,12507,1242976,294723,1537699,771284,374559,290894,3624,1540,100,75
Orissa,Khordha,20.054162322274863,85.52234834123229,386,2251673,1167137,1084536,1749936,957515,792421,2147632,84060,12527,1264,475,476,434,4805,688729,276378,445785,436534,295099,177974,247498,66645,1945913,371244,2317157,1199521,653346,391701,7105,4186,92,77
Orissa,Koraput,18.82627794779476,82.81278469846964,398,1379647,678809,700838,568090,340843,227247,1294151,8850,68550,518,219,491,3384,3484,460128,158847,158653,98266,60589,32257,29000,10200,547812,770707,1318519,818578,348803,207206,5060,1519,103,41
Orissa,Malkangiri,18.25227930367506,81.98293636363628,399,613192,303624,309568,244706,147001,97705,600219,1871,10039,213,43,195,35,577,183723,60913,64683,44962,19031,8487,5585,1202,204863,390356,595219,381913,146355,83284,1640,564,101,39
Orissa,Mayurbhanj,21.897621545157754,86.4030408052231,376,2519738,1256213,1263525,1369397,794171,575226,2113079,33706,15008,661,162,109,351714,5299,753589,283489,390037,385216,214921,92060,72847,17415,1455985,1094844,2550829,1449729,650135,414076,5798,2747,100,54
Orissa,Nayagarh,20.192895622119817,85.05614700460825,385,962789,502636,460153,688362,392333,296029,955754,5278,383,107,33,24,12,1198,288334,174904,227102,177180,90089,36951,33148,5685,745059,232558,977617,502136,262086,196994,1573,984,91,71
Orissa,Nuapada,20.471309512195116,82.59152536585364,394,610382,301962,308420,299383,180903,118480,601092,4952,1778,724,76,905,22,833,209127,64389,114394,73787,51886,19577,10131,4316,338480,316086,654566,344075,152681,112325,1301,205,102,49
Orissa,Puri,19.83509174603177,85.86698989898981,387,1698730,865380,833350,1291939,704857,587082,1644905,46094,4239,193,243,94,302,2660,474224,251520,413605,364098,179086,84374,87000,15511,1395194,309790,1704984,888134,477430,328666,4500,2027,96,76
Orissa,Rayagada,19.292840020060204,83.45860120361095,396,967911,471960,495951,407735,241959,165776,874445,4607,84916,219,249,123,44,3308,286548,84956,97387,73210,46001,21439,17681,6306,346980,583140,930120,577569,245766,140825,3751,1074,105,42
Orissa,Sambalpur,21.515752380952385,84.34958483245157,372,1041099,526877,514222,703691,393192,310499,964188,20120,50637,2506,310,86,1117,2135,315495,133005,185289,171876,108455,50705,45828,13071,708229,282248,990477,565700,286575,186726,2098,1548,97,67
Orissa,Sundargarh,22.06354819277107,84.50524819277099,374,2093437,1061147,1032290,1342322,750147,592175,1532352,71391,385011,5713,710,721,89986,7553,618062,208100,350349,335380,243386,120373,94710,36590,1388888,660465,2049353,1188918,573238,324436,6845,3130,97,64
Puducherry,Karaikal,10.876161726078813,79.82369793621002,637,200222,97809,102413,154916,79903,75013,152638,28835,18391,46,63,54,14,181,69333,18943,32899,33458,29456,15930,18998,4877,154561,32717,187278,102333,60089,37434,366,4890,104,77
Puducherry,Mahe,12.006420793787758,75.28275021570326,636,41816,19143,22673,36470,16610,19860,27940,12856,958,3,21,14,3,21,12110,2948,6043,7930,8773,5711,4475,978,36858,2993,39851,19760,12543,9428,85,10027,118,87
Puducherry,Yanam,16.707695652173904,82.26187304347832,634,55626,27301,28325,39274,19919,19355,53537,1191,873,3,1,4,4,13,15519,3804,10954,8806,8044,4101,3836,1315,40860,14923,55783,31973,15235,8402,16,10027,103,70
Punjab,Amritsar,31.548679820627772,74.79883856502238,49,2490656,1318408,1172248,1684770,932981,751789,690939,12502,54344,1716935,876,3152,1044,10864,660953,197944,313874,283819,328229,203656,142399,15879,1485800,540010,2025810,1384987,667193,436496,1980,6979,88,67
Punjab,Bathinda,30.190524611973352,75.05685898004438,46,1388525,743197,645328,844868,488261,356607,380569,16299,2474,984286,246,1266,559,2826,355722,117795,182796,145626,163928,96329,70240,16666,793380,438529,1231909,754927,377707,255283,608,3365,86,60
Punjab,Faridkot,30.591187250996025,74.79751553784862,45,617508,326671,290837,381285,215767,165518,141363,3125,1227,469789,155,1109,103,637,158863,53734,89433,71178,75419,48360,29838,5790,373752,204895,578647,336540,164962,113721,2285,1540,89,61
Punjab,Fatehgarh Sahib,30.64290947368421,76.36208394736842,40,600163,320795,279368,426033,238696,187337,152851,16808,1698,427521,48,178,251,808,174896,51897,102257,83931,95073,59555,34990,4607,432310,142314,574624,321018,166781,111028,1336,1640,87,70
Punjab,Firozpur,30.63407535211269,74.40245732394365,43,2029074,1071637,957437,1227511,707070,520441,906408,6844,19358,1090815,454,1143,278,3774,502390,196971,306838,226433,221806,147698,82448,25734,1207928,714869,1922797,1171770,525459,331259,586,4283,89,60
Punjab,Gurdaspur,32.04283371212125,75.3204064393939,35,2298323,1212617,1085706,1634719,907660,727059,1074332,27667,176587,1002874,405,580,812,15066,606348,180897,315156,290618,372317,243539,104345,22107,1528979,478020,2006999,1261421,611353,423301,2248,5982,89,71
Punjab,Hoshiarpur,31.55157169811319,75.8469857442349,38,1586625,809057,777568,1199699,637927,561772,1000743,23089,14968,538208,3476,2034,531,3576,551265,143871,256127,238975,301435,176013,93618,17427,1227466,294723,1522189,831741,422782,330671,1431,4305,96,75
Punjab,Jalandhar,31.250336907216507,75.54400350515463,37,2193590,1145211,1048379,1622537,882581,739956,1394329,30233,26016,718363,11385,4011,805,8448,708130,183441,333736,304652,339758,216646,162965,34576,1575774,387809,1963583,1159156,616431,416449,1554,6883,91,73
Punjab,Kapurthala,31.336592638036837,75.47641165644177,36,815168,426311,388857,576567,316254,260313,336124,10190,5445,453692,6662,553,334,2168,261203,71698,127031,112774,128828,77442,48221,9501,575495,174995,750490,433331,222324,157833,1680,2472,91,70
Punjab,Ludhiana,30.76596397379912,75.83110851528383,41,3498739,1867816,1630923,2560225,1428348,1131877,1502403,77713,16517,1863408,2007,19620,1254,15817,1036821,277247,488129,443759,527568,318876,272280,44240,2372099,631980,3004079,1901528,980046,614258,2907,10593,87,73
Punjab,Mansa,29.919547714285724,75.4304922857143,47,769751,408732,361019,423560,244037,179523,156539,10375,917,598443,123,1577,493,1284,196389,75708,106162,84553,85953,48663,27461,5658,434158,311513,745671,420050,200882,146103,2716,1694,88,55
Punjab,Moga,30.756540067340065,75.1600845117845,42,995746,525920,469826,627889,348549,279340,158414,9388,3277,818921,178,436,365,4767,288439,98764,158812,116716,128693,85642,37417,11956,638000,306336,944336,535408,258826,194768,6744,2774,89,63
Punjab,Muktsar,30.31243303303303,74.5518747747748,44,901896,475622,426274,524848,300401,224447,254920,4333,1681,638625,240,744,433,920,224157,90240,137470,101852,104682,62612,36905,10666,544427,340886,885313,495167,242628,162297,1804,2025,89,58
Punjab,Patiala,30.214540380693364,76.27505893949697,48,1895686,1002522,893164,1266791,711052,555739,783306,40043,5683,1059944,245,1914,1410,3141,517369,173890,283837,239609,256826,157435,141947,27272,1280816,518772,1799588,1042519,517079,335100,988,5679,89,66
Punjab,Rupnagar,30.910937330754347,76.53743500967126,51,684627,357485,327142,502731,278534,224197,304481,14492,2094,361045,118,653,143,1601,208699,53005,107715,98135,116836,68794,38823,9388,492696,124100,616796,365300,185424,131707,2196,2034,91,73
Punjab,Sangrur,30.185045204336895,75.89437014178496,53,1655169,878029,777140,1002077,570413,431664,389410,179116,2406,1077438,268,3222,1038,2271,448944,163251,250833,197901,220210,130155,73636,18393,1054379,570103,1624482,904316,435148,311621,4084,3943,88,60
Rajasthan,Ajmer,26.199300378787903,74.6990419191919,119,2583052,1324085,1258967,1526673,926268,600405,2201663,314159,10605,6799,417,45614,184,3611,684254,379043,394576,313680,200191,130608,172683,28138,1618919,1034334,2653253,1561077,629951,388040,3984,4339,95,59
Rajasthan,Alwar,27.55271738035265,76.65359630562563,104,3674179,1939026,1735153,2182476,1359829,822647,3039279,547335,2696,64532,4384,13221,348,2384,995261,492781,492981,468628,324050,230415,222622,31390,2262867,1384905,3647772,2346721,836000,490137,1321,5732,89,59
Rajasthan,Banswara,23.453642032967014,74.44246868131869,125,1797485,907754,889731,829343,513854,315489,1701234,48834,22250,427,138,22613,109,1880,429844,240067,190259,137780,75011,50438,47094,8145,748794,1040914,1789708,1153029,406214,216554,21688,2734,98,46
Rajasthan,Baran,24.98023243243244,76.86210651828291,128,1222755,633945,588810,693307,432607,260700,1133349,79984,1432,3066,84,2795,48,1997,318988,203489,194024,144190,76209,46847,49939,8057,722755,545842,1268597,762204,286344,173100,1107,1741,92,56
Rajasthan,Barmer,25.77070908045978,71.50297126436782,115,2603751,1369022,1234729,1188322,783461,404861,2244882,321192,1157,450,157,34010,34,1869,598805,406804,352636,219932,101291,52272,39533,7328,1179796,1501858,2681654,1731122,527629,326476,18524,3437,90,45
Rajasthan,Bharatpur,27.32411858037578,77.21752077244258,105,2548462,1355726,1192736,1480869,943910,536959,2143046,371286,1576,23456,899,5758,18,2423,609134,363676,330336,314953,211938,147520,132571,23311,1524305,1104824,2629129,1659515,546362,329127,13458,3699,87,58
Rajasthan,Bhilwara,25.45119767759564,74.63947595628417,122,2408523,1220736,1187787,1256126,777582,478544,2224839,142427,1978,1468,183,35149,60,2419,675880,398993,338296,258990,141250,92785,106667,10928,1347909,1180456,2528365,1439454,589476,365023,14570,3694,97,52
Rajasthan,Bikaner,28.12489068322981,73.26943322981371,101,2363937,1240801,1123136,1278801,782399,496402,2073356,235741,1901,20072,285,30850,79,1653,531933,410155,333211,254335,143669,80296,101714,18577,1341957,1015331,2357288,1543867,517271,288165,14634,3411,90,54
Rajasthan,Bundi,25.48580716049379,75.79984074074079,121,1110906,577160,533746,585044,371705,213339,1017688,66609,682,11059,144,13455,24,1245,303288,153500,159218,121104,63248,41227,41052,6460,585809,553622,1139431,686771,267648,155958,529,1723,92,52
Rajasthan,Chittaurgarh,24.631623761665463,74.80010997846382,126,1544338,783171,761167,821825,514851,306974,1413163,97855,1274,1515,252,25843,136,4300,455653,245603,225700,170455,90889,58129,67155,10768,868699,715545,1584244,880043,398303,258997,6995,3238,97,53
Rajasthan,Churu,28.29330375536484,74.65846427038629,102,2039547,1051446,988101,1149269,696729,452540,1777879,249736,958,402,188,7104,127,3153,493893,336671,302022,237220,161520,100677,77282,13320,1228712,910226,2138938,1293193,458725,272176,15453,3361,93,56
Rajasthan,Dausa,26.91234817629181,76.57342097264443,109,1634409,857787,776622,938051,596935,341116,1582335,45488,439,296,94,3737,115,1905,420694,229035,235474,208537,135234,92559,90833,13764,1005436,681980,1687416,1047136,358718,210117,18438,2286,90,57
Rajasthan,Dhaulpur,26.72397054945053,77.74476219780222,106,1206516,653647,552869,683098,435721,247377,1127520,72258,688,1356,92,2739,21,1842,273296,207566,172914,132964,77360,45590,37856,8194,682444,552106,1234550,815651,248416,141365,1084,1641,84,56
Rajasthan,Dungarpur,23.75104807692308,73.84765641025645,124,1388552,696532,692020,681591,415820,265771,1340065,28662,830,240,226,16141,853,1535,354363,238847,175059,114245,60656,42887,39312,4834,675840,764563,1440403,868458,317700,191917,10477,2030,99,49
Rajasthan,Ganganagar,29.256785412667963,73.56192303262948,99,1969168,1043340,925828,1193343,710908,482435,1437144,50688,2077,474853,938,1988,164,1316,562594,237042,314107,238397,163098,105734,104071,19396,1181845,710223,1892068,1167889,502211,283484,15584,3332,88,60
Rajasthan,Hanumangarh,29.1813351791531,74.74632573289902,100,1774692,931184,843508,1034136,624281,409855,1433067,118673,1542,216997,241,1935,138,2099,497753,239601,273441,219194,153628,104087,84185,14416,1088552,723454,1812006,1058044,453114,242361,21173,2709,90,58
Rajasthan,Jaipur,27.033459290187885,75.77117286012533,110,6626178,3468507,3157671,4300965,2554793,1746172,5819980,687452,12708,18782,1020,81079,257,4900,1732679,819004,875940,823570,659389,455527,703673,96562,4433665,2046038,6479703,4091148,1646480,884057,4493,12219,91,64
Rajasthan,Jaisalmer,26.86900838548185,71.18371877346682,114,669919,361708,308211,308653,210415,98238,497045,168129,874,1723,98,1521,34,495,189947,109484,71132,41264,20142,12759,10604,1720,267105,397649,664754,448969,140294,79977,679,986,85,46
Rajasthan,Jalor,25.07578093797277,72.18647261724662,116,1828730,936634,892096,829582,543923,285659,1732852,78990,730,231,144,14640,82,1061,467418,270997,277152,181691,75304,32366,25210,7850,870570,1033534,1904104,1176496,390598,249379,12257,2470,95,45
Rajasthan,Jhalawar,24.24725541474657,76.11242891705065,129,1411129,725143,685986,739792,466815,272977,1299751,96164,842,819,46,12488,42,977,362387,226614,203488,143108,73388,46267,47985,6972,747822,696680,1444502,850546,346110,213674,799,1962,94,52
Rajasthan,Jhunjhunun,28.13517401247401,75.52840893970894,103,2137045,1095896,1041149,1370360,815834,554526,1905682,228178,1004,275,56,548,85,1217,650809,296093,305626,301866,256621,192240,158936,25286,1536668,712584,2249252,1298780,494124,330126,14015,3300,95,64
Rajasthan,Jodhpur,26.678460838536967,73.00450847457628,113,3687165,1923928,1763237,2031532,1265753,765779,3224399,411558,6035,4123,514,36697,80,3759,891657,497762,512035,405132,259304,154789,177199,30720,2036941,1591957,3628898,2359786,836322,489280,1777,5708,91,55
Rajasthan,Karauli,26.51901555555556,76.96081818181815,107,1458248,783639,674609,805849,531904,273945,1370977,81553,602,297,70,3424,413,912,364355,220644,193938,170399,104208,69443,67639,14402,840673,668926,1509599,947173,310688,192042,8345,1987,86,55
Rajasthan,Kota,25.175718080000014,76.18618928000001,127,1951014,1021161,929853,1298345,765396,532949,1661307,243993,5665,11058,280,25742,286,2683,515189,286676,294591,250092,172538,118710,167778,27485,1317870,588142,1906012,1177474,495896,275396,2248,3394,91,66
Rajasthan,Nagaur,27.07862016048146,74.14215667001012,112,3307743,1696325,1611418,1758624,1102750,655874,2833443,454487,1912,366,163,12940,276,4156,842201,513871,486057,388822,242053,147701,117444,14853,1910801,1533137,3443938,2088323,754143,463469,1808,4863,94,53
Rajasthan,Pali,25.80490393541874,73.55285640766907,118,2037573,1025422,1012151,1085693,667381,418312,1870543,143476,1345,1540,141,18974,52,1502,652717,293818,359329,271312,144581,71472,67021,9403,1216936,983050,2199986,1207983,467436,343384,18770,3317,98,53
Rajasthan,Rajsamand,25.24894767441859,73.96570215946844,123,1156597,581339,575258,619139,383334,235805,1105676,33677,759,260,100,14966,68,1091,365676,190090,190388,140839,72969,41063,34286,4732,674367,544517,1218884,687165,275099,193668,665,1821,98,53
Rajasthan,Sawai Madhopur,26.251081180223288,76.4219283891548,108,1335551,704031,631520,741748,486184,255564,1165505,155681,945,812,177,9991,42,2398,353321,205450,172925,151108,87349,57625,70870,14384,759711,586492,1346203,841697,309237,183234,1383,1900,89,55
Rajasthan,Sikar,27.64644058641976,75.29317422839503,111,2677333,1374990,1302343,1652117,995275,656842,2342076,327583,1122,356,177,4050,15,1954,705834,369959,438872,367412,282595,200430,181282,19321,1859871,967497,2827368,1672813,605002,381226,18292,4033,94,61
Rajasthan,Sirohi,24.7976905263158,72.75309131578943,117,1036346,534231,502115,476806,309900,166906,996562,30479,1284,572,114,6829,56,450,308174,117971,147381,110385,58213,30724,27076,5251,497001,577092,1074093,649290,244401,142251,404,1621,93,46
Rajasthan,Tonk,26.153935071707927,75.79192216427637,120,1421326,728136,693190,749659,478329,271330,1243527,153146,754,378,122,22458,30,911,380666,237191,190750,154825,91853,64431,67155,9919,816124,661902,1478026,880194,334006,205593,1533,2145,95,52
Rajasthan,Udaipur,24.44076752136749,73.84029839743584,130,3068420,1566801,1501619,1582629,973444,609185,2869976,104307,7406,4278,209,78647,373,3224,848218,442946,386075,277392,164290,102085,142672,20010,1535470,1528671,3064141,1876436,739287,451034,1663,5101,95,51
Sikkim,East,27.29600352941175,88.74908392156858,93,1709346,907500,801846,1352998,748382,604616,1410852,178807,15792,53027,2643,46927,366,932,462218,86484,219061,260094,267825,235187,246988,18644,1334283,169693,1503976,948963,497157,262124,1102,7151,88,79
Tamil Nadu,Ariyalur,11.190514836795256,79.22249643916912,616,754894,374703,380191,480604,269582,211022,708397,7942,37403,104,88,65,42,853,254277,60697,134123,113437,96860,53934,57524,16126,532701,233438,766139,380484,216103,157771,536,1258,101,63
Tamil Nadu,Chennai,13.058098905608748,80.28139151846806,603,4646732,2335844,2310888,3776276,1968079,1808197,3751322,439270,358662,2851,2804,51708,1759,38356,1314125,167207,516445,720331,801050,464207,905515,67277,3642032,419065,4061097,2271657,1468902,899279,6894,15742,98,81
Tamil Nadu,Coimbatore,10.871376995940452,77.07619012178621,632,3458045,1729297,1728748,2635907,1394790,1241117,3044145,211035,190314,1112,435,3284,237,7483,1169752,220388,466745,523563,526165,273098,440520,53709,2504188,519919,3024107,1579517,1117221,757738,3569,13938,99,76
Tamil Nadu,Cuddalore,11.57587300613498,79.63002365371497,617,2605914,1311697,1294217,1815281,1000322,814959,2391675,123749,83334,401,236,1280,138,5101,758209,169844,412237,418769,386652,186394,227530,67411,1868837,634041,2502878,1364411,764669,473617,3217,5300,98,69
Tamil Nadu,Dharmapuri,12.300141200000006,78.11509813333339,630,1506843,774303,732540,917709,527599,390110,1452956,38304,14089,164,39,37,87,1167,487926,129778,240222,221194,177877,103367,112592,26069,1011099,512824,1523923,804186,434328,267536,793,2364,94,60
Tamil Nadu,Dindigul,10.377801390820574,77.78011279554937,612,2159775,1080938,1078837,1481834,816180,665654,1879494,105012,169945,313,256,71,138,4546,713542,207751,386421,372636,282628,153100,163050,29443,1595029,480681,2075710,1065734,647806,443528,2707,4682,99,68
Tamil Nadu,Erode,11.267012155963302,77.42034334862392,610,2251744,1129868,1121876,1492662,828300,664362,2115455,76098,55899,435,148,639,157,2913,843684,175017,345914,319484,269016,155344,215514,30391,1510680,608003,2118683,1006543,701326,542295,1580,7719,99,66
Tamil Nadu,Kancheepuram,12.496424756511884,80.08820360135913,604,3998252,2012958,1985294,3013382,1611461,1401921,3537399,173785,256762,1620,990,4962,756,21978,1213504,183054,535947,608188,634172,312208,526886,67354,2867809,678374,3546183,2076492,1200284,715895,5581,8349,98,75
Tamil Nadu,Kanniyakumari,8.183466300191206,77.32053064053538,629,1870374,926345,944029,1548738,780541,768197,909872,78590,876299,160,438,156,10,4849,598041,134236,331559,314029,322511,226312,254107,43034,1625788,210901,1836689,887052,556548,425849,925,4377,101,82
Tamil Nadu,Karur,10.79532776617955,78.08749686847604,613,1064493,528184,536309,727044,401726,325318,993666,53292,16483,115,29,7,79,822,364661,76629,190229,167466,146666,77874,85595,14951,759410,276930,1036340,501585,320645,241843,420,2151,101,68
Tamil Nadu,Madurai,9.904313833333331,78.01366033333332,623,3038252,1526475,1511777,2273430,1223810,1049620,2760502,168881,97711,520,199,1532,305,8602,1010441,234611,525151,532616,453509,250285,363152,39350,2398674,449125,2847799,1528178,913715,593827,2532,6917,99,74
Tamil Nadu,Nagapattinam,10.789468161718286,79.79437299431483,618,1616450,798127,818323,1213008,640916,572092,1435072,128617,47579,184,450,963,110,3475,517740,136593,323359,313357,249630,122350,125639,35762,1306690,253572,1560262,828444,463326,323706,974,3026,102,75
Tamil Nadu,Namakkal,11.33766638477801,78.14624841437633,609,1726601,869280,857321,1176131,653312,522819,1673652,32483,16909,183,108,84,199,2983,627484,123573,297179,247516,214836,126468,169206,21582,1200360,388418,1588778,817905,510413,397064,1219,3824,98,68
Tamil Nadu,Perambalur,11.260137758112096,78.86034011799416,615,565223,282157,283066,375823,208011,167812,521658,32702,10301,83,39,38,26,376,188592,85210,106751,85101,71650,41447,44025,9189,443373,109011,552384,291371,158218,115151,483,979,100,66
Tamil Nadu,Pudukkottai,10.130514816433578,79.05444484265728,621,1618345,803188,815157,1110545,608776,501769,1428784,114194,72850,119,81,32,293,1992,503941,97231,283299,270046,251855,121706,111731,31315,1167183,447346,1614529,835853,470428,311175,889,2812,101,68
Tamil Nadu,Ramanathapuram,9.31286995153476,78.99185362412462,626,1353445,682658,670787,978946,536487,442459,1047411,208038,91139,154,86,29,36,6552,417239,246909,293886,236511,189132,105978,97405,16785,1186606,107292,1293898,708322,389764,252888,2471,2340,98,72
Tamil Nadu,Salem,11.629324202127655,78.2478257978723,608,3482056,1781571,1700485,2285562,1285107,1000455,3326357,95487,53841,412,174,992,246,4547,1170352,188672,571061,518763,457866,242306,296399,60365,2335432,955045,3290477,1737345,1029479,713294,1938,8169,95,65
Tamil Nadu,Sivaganga,9.960306580645158,78.56535729032255,622,1339101,668672,670429,959744,526304,433440,1186078,74310,75481,150,80,109,24,2869,452417,101778,216931,236700,199263,103903,115894,23941,998410,311112,1309522,666218,391356,280462,1065,2456,100,71
Tamil Nadu,Thanjavur,10.387692255892237,79.3194869107745,620,2405890,1182416,1223474,1790998,944264,846734,2075870,190814,133971,231,795,1256,148,2805,753372,138375,431983,419605,373111,178126,222410,49261,1812871,461123,2273994,1193095,712017,499235,1543,4914,103,74
Tamil Nadu,Theni,9.924066666666668,77.43458833333332,624,1245899,625683,620216,870080,479403,390677,1148990,56751,37574,152,79,28,74,2251,410623,90590,219747,213496,156676,95231,101147,14674,891561,270738,1162299,618923,373564,252267,1145,2642,99,69
Tamil Nadu,Thiruvallur,13.275858101752885,80.19724702864492,602,3728104,1876062,1852042,2791721,1495711,1296010,3325823,143093,233633,1422,951,3693,530,18959,1119433,181452,461918,600731,622789,303091,451321,66378,2687680,610048,3297728,1925296,1154775,643614,4419,7731,98,74
Tamil Nadu,Thiruvarur,10.368927409395978,79.60322893959727,619,1264277,626693,637584,946471,503085,443386,1132785,96092,33192,258,151,279,64,1456,408179,138960,250163,243773,203450,103908,99082,28166,1067502,175564,1243066,627880,377118,257116,2163,2272,101,74
Tamil Nadu,Tiruvannamalai,12.419318947368414,79.23265631578953,606,2464875,1235889,1228986,1626813,909803,717010,2294369,91636,66987,232,157,7898,110,3486,710163,203879,442688,423135,343955,174560,158041,36454,1782712,672427,2455139,1301347,683904,477668,1956,4189,99,65
Tamil Nadu,Vellore,12.784882632293078,79.02643283582084,605,3936331,1961688,1974643,2773928,1504355,1269573,3397857,414760,111390,676,438,3514,251,7445,1140300,191963,721473,719731,641585,311434,308514,71127,2965827,891430,3857257,2096113,1116437,720713,3068,8092,100,70
Tamil Nadu,Virudhunagar,9.468872195892564,77.87641469194315,625,1942288,967709,974579,1398788,760375,638413,1822626,47838,67405,245,87,98,75,3914,734724,163264,398670,317054,230321,138306,167506,35156,1450277,403246,1853523,987538,575006,378174,1570,4300,100,72
Tripura,Dhalai,23.781360477941163,91.94654283088232,291,378230,194544,183686,276217,151643,124574,307120,8256,22940,175,39120,85,206,328,103528,64515,84516,74015,21430,9157,6425,890,260948,109130,370078,232286,95548,50269,127,455,94,73
Tripura,North Tripura,24.121739755351683,92.17842538226292,292,693947,352860,341087,520402,275646,244756,507967,105737,44062,151,34717,307,70,936,192621,129329,179547,158211,47160,22720,18419,3736,559122,156840,715962,414878,178608,100274,187,848,96,74
Tripura,South Tripura,23.211874098057383,91.6065807585568,290,876001,447544,428457,646810,351082,295728,736015,49258,39258,245,49420,106,808,891,264077,129846,223185,204201,70173,31690,26870,5160,691125,188363,879488,505558,236676,133424,343,1118,95,73
Tripura,West Tripura,23.780166241299337,91.41310788863107,289,1725739,879428,846311,1361354,722998,638356,1512801,152791,53622,499,2128,362,430,3106,506637,248343,421485,451563,156277,88122,85405,13478,1464673,279053,1743726,940424,499719,284637,959,2817,96,78
Uttar Pradesh,Agra,26.99512974910393,78.05278291517321,146,4418797,2364953,2053844,2680510,1614594,1065916,3922718,411313,10076,12057,4049,21508,384,36692,903823,600839,904836,647340,450571,317618,199395,20781,3141380,963202,4104582,2871903,991255,547873,7766,5982,86,60
Uttar Pradesh,Aligarh,27.93748576850093,78.00146831119557,143,3673889,1951996,1721893,2092567,1283380,809187,2904140,729283,7635,5875,2582,2805,91,21478,858059,456870,491605,443958,334738,216997,172585,20498,2137251,1352181,3489432,2378289,787408,472667,35525,4290,88,56
Uttar Pradesh,Allahabad,25.392038662316445,82.05172446982063,175,5954391,3131807,2822584,3665727,2199340,1466387,5102041,796756,13782,4377,4391,2247,305,30492,1248570,823863,934881,738076,596615,502826,428871,36764,4061896,1756098,5817994,3764404,1335224,818137,36626,7224,90,61
Uttar Pradesh,Ambedkar Nagar,26.39119025974028,82.68282142857147,178,2397888,1212410,1185478,1486939,846676,640263,1985654,401678,2536,869,1817,235,33,5066,566590,342667,392873,353570,247028,172872,194387,15458,1718855,813502,2532357,1499494,515229,367234,15931,2797,97,62
Uttar Pradesh,Auraiya,26.66892394014961,79.42637057356607,162,1379545,740040,639505,930836,546198,384638,1273546,101963,1004,371,332,228,444,1657,314274,133123,291837,282449,168866,101542,79012,6531,1063360,276224,1339584,856336,320763,202054,392,1510,86,67
Uttar Pradesh,Azamgarh,26.008290954773837,83.01220251256285,191,4613913,2285004,2328909,2771917,1559414,1212503,3878626,718692,3810,719,5652,183,226,6005,971458,831966,1344726,879745,489060,312571,158303,8087,4024458,1218146,5242604,2930243,965876,699954,17840,5419,101,60
Uttar Pradesh,Baghpat,29.045793499999988,77.30266300000001,139,1303048,700070,602978,797970,489858,308112,917474,364583,1840,483,161,16139,25,2343,316046,139646,272939,215070,132197,79475,44164,3730,887221,376700,1263921,817140,283276,194548,8084,1514,86,61
Uttar Pradesh,Bahraich,27.691776300578027,81.46779783237004,180,3487731,1843884,1643847,1398368,878285,520083,2291892,1169330,6400,8212,2793,1177,38,7889,760262,447648,493760,215939,104762,65106,47690,7028,1381933,1920966,3302899,2275746,754346,446242,11397,3060,89,40
Uttar Pradesh,Ballia,25.86075638297873,84.03651978723408,193,3239774,1672902,1566872,1963590,1160960,802630,3004240,213440,4463,892,1595,233,64,14847,629381,436021,515010,443440,409484,323582,200434,20283,2348254,1032533,3380787,1975934,724362,502628,36850,3634,93,60
Uttar Pradesh,Balrampur,27.449076537911324,82.47158326180256,182,2148665,1114721,1033944,868357,544943,323414,1333242,805975,3228,900,1866,198,87,3169,445838,379253,227932,122911,65516,40633,37109,2777,876131,1332817,2208948,1415213,442339,283947,7166,2174,92,40
Uttar Pradesh,Banda,25.351885902503284,80.52487391304344,170,1799410,965876,833534,1002937,630626,372311,1637549,157612,1367,231,168,916,50,1517,445625,325773,415195,249238,114783,61702,63112,5728,1235531,588025,1823556,1120432,408527,265310,5141,1949,86,55
Uttar Pradesh,Bara Banki,26.922777025232424,81.35762350597606,176,3260699,1707073,1553626,1692458,1010518,681940,2505444,737106,4857,2090,1553,3016,211,6422,714908,533140,420824,350564,197780,132332,113799,12281,1760720,1540841,3301561,2043335,709494,445269,62601,3230,91,51
Uttar Pradesh,Bareilly,28.51101940789474,79.43187072368416,150,4448359,2357665,2090694,2191759,1342697,849062,2830768,1536534,14822,28187,4371,931,339,32407,994411,717585,641251,442110,272840,172554,146446,16806,2409592,1744527,4154119,2893965,952233,514141,88020,5126,88,49
Uttar Pradesh,Basti,26.833880454545447,82.69790590909092,185,2464464,1255272,1209192,1393783,819719,574064,2082976,364510,3493,900,9753,107,99,2626,545025,470355,349221,324085,211477,162961,143642,13030,1674771,1021192,2695963,1574037,519265,363891,7271,2775,96,56
Uttar Pradesh,Bijnor,29.313974259681096,78.45098815489754,134,3682713,1921215,1761498,2135393,1241471,893922,2032081,1585210,6184,50624,1736,2134,41,4703,908523,498971,827447,549594,255028,159528,148185,14658,2453411,1308683,3762094,2404576,786305,450186,41646,4310,91,57
Uttar Pradesh,Bulandshahr,28.34875862068968,78.01082758620684,142,3499171,1845260,1653911,2031656,1253314,778342,2707195,777407,4088,2765,669,1572,86,5389,880077,443641,540754,475146,338138,217882,151182,17796,2184539,1185318,3369857,2246254,753949,472808,26160,4534,89,58
Uttar Pradesh,Chandauli,25.1180859611231,83.25307062634984,196,1952756,1017905,934851,1174606,699454,475152,1727869,215081,2153,1389,340,100,1175,4649,395759,295979,367768,276638,196240,135962,88299,7586,1368472,543247,1911719,1222695,437000,287767,5294,2183,91,60
Uttar Pradesh,Chitrakoot,25.159924623803,81.07666087551297,171,991730,527721,464009,531072,330339,200733,955372,34559,693,63,101,285,27,630,230795,168472,174106,124256,69641,40266,35826,3660,616227,383908,1000135,638046,214228,136669,2787,1019,87,53
Uttar Pradesh,Deoria,26.42218856548857,83.8244070686071,190,3100946,1537436,1563510,1875239,1079288,795951,2730957,358539,3626,818,1182,209,146,5469,665706,602403,473097,449571,372031,277548,194341,23334,2392325,1130108,3522433,1946336,664708,481219,8683,3643,101,60
Uttar Pradesh,Etah,27.591155309734443,78.70021858407083,201,1774480,947339,827141,1055202,647042,408160,1611126,146346,2464,708,2887,5671,18,5260,401998,238019,214091,201984,178434,119665,88607,8092,1048892,718310,1767202,1149372,383707,237427,3974,3461,87,59
Uttar Pradesh,Etawah,26.78817670157068,79.07621806282728,161,1581810,845856,735954,1062003,623583,438420,1457892,113961,1362,1045,1733,3917,94,1806,351126,171216,292852,298700,195192,121283,118571,13400,1211214,397708,1608922,979633,362026,237786,2365,1825,87,67
Uttar Pradesh,Faizabad,26.60589185185181,82.00783530864202,177,2470996,1259628,1211368,1450901,838339,612562,2094271,365806,3225,1912,737,358,185,4502,589666,356093,361114,347114,231129,176303,179996,18947,1670696,981915,2652611,1534832,543148,367332,25684,2985,96,58
Uttar Pradesh,Farrukhabad,27.45063297872342,79.4406284574468,159,1885204,1006240,878964,1092677,654827,437850,1596278,276846,3137,3160,3161,487,100,2035,411490,270550,330084,257279,184298,115069,110391,9368,1277039,710960,1987999,1224584,411153,246795,2672,2058,87,57
Uttar Pradesh,Fatehpur,25.8374362030905,80.85416203090509,172,2632733,1384722,1248011,1512166,911003,601163,2274674,350700,2201,402,172,199,47,4338,636540,409875,463642,376472,227119,134445,116445,10212,1738210,895178,2633388,1624830,603831,395547,8525,2868,90,57
Uttar Pradesh,Firozabad,27.20963993055552,78.42660624999998,147,2498156,1332046,1166110,1521806,912314,609492,2140745,314812,3370,1804,3395,19077,61,14892,535368,324525,416295,368905,277163,166249,108627,11313,1673077,672115,2345192,1621154,543730,312689,20583,2940,87,60
Uttar Pradesh,Gautam Buddha Nagar,28.393311038961038,77.52462467532465,141,1648115,890214,757901,1122947,666065,456882,1394025,215500,7366,9261,895,4518,91,16459,509770,201277,330623,283031,218587,194796,101645,5058,1335017,342284,1677301,1015648,402967,188862,40638,2578,85,68
Uttar Pradesh,Ghaziabad,28.74997308584685,77.67441879350343,140,4681645,2488834,2192811,3123264,1811397,1311867,3414427,1186776,19026,23001,3487,16412,265,18251,1191723,534606,858286,797473,597661,475439,255949,26399,3545813,885070,4430883,2891069,1139871,559963,90742,5946,88,66
Uttar Pradesh,Ghazipur,25.624724775583484,83.5360854578097,195,3620268,1855075,1765193,2197549,1293553,903996,3233790,368153,4181,810,3145,213,184,9792,761640,566504,691057,563310,449909,334003,186306,12795,2803884,1008996,3812880,2234593,774130,556273,55272,4079,95,60
Uttar Pradesh,Gonda,27.157215552099505,82.0226888024882,183,3433919,1787146,1646773,1679994,1034181,645813,2739076,678615,4735,1893,649,338,57,8556,726372,678171,425584,305644,192664,144067,118176,8722,1873028,1620782,3493810,2223078,734903,464584,11354,3614,92,48
Uttar Pradesh,Gorakhpur,26.63315886792452,83.3549560377358,188,4440895,2277777,2163118,2700328,1593890,1106438,4009037,403847,9662,2123,2848,460,207,12711,951128,873031,618398,560246,425913,316166,273903,36253,3103910,1453960,4557870,2755630,992114,659677,33474,5455,94,60
Uttar Pradesh,Hamirpur,25.738158381502892,79.82619479768789,28,454768,217070,237698,358091,180555,177536,449412,3711,243,591,95,293,9,414,211348,37327,71107,72114,91184,64363,35620,5263,376978,72551,449529,224044,123941,106641,142,878,109,78
Uttar Pradesh,Hamirpur,25.738158381502892,79.82619479768789,168,1104285,593537,510748,653299,408125,245174,1010014,91269,814,196,74,41,273,1604,311381,159593,238344,211029,103334,59914,59612,4094,835920,364848,1200768,660774,260368,181109,2034,1291,86,59
Uttar Pradesh,Hardoi,27.337409090909137,80.26411767676768,155,4092845,2191442,1901403,2221601,1374587,847014,3508131,556219,5822,5688,6671,446,98,9770,907677,741817,906861,510507,247265,138583,103523,9048,2657604,1481604,4139208,2598364,905306,559988,29187,4209,86,54
Uttar Pradesh,Jalaun,26.067954587155988,79.36686911314993,165,1689974,906092,783882,1075196,653430,421766,1509708,171581,1148,463,2875,256,145,3798,396421,169207,327534,282919,167911,104699,106888,10399,1169557,461666,1631223,1002817,410090,274954,2113,1906,86,63
Uttar Pradesh,Jaunpur,25.70141280913127,82.54315351934063,194,4494204,2220465,2273739,2731677,1565394,1166283,3981502,483750,4947,1286,7898,349,114,14358,1006670,665376,939616,769693,520111,353996,256398,25909,3531099,1344789,4875888,2826453,927026,689979,50746,5261,102,60
Uttar Pradesh,Jhansi,25.45581535234902,78.89954580536917,166,1998603,1057436,941167,1304513,783705,520808,1823930,147842,7050,4951,1203,7328,311,5988,504913,184997,370685,341371,186348,99814,92586,11783,1287584,483088,1770672,1171301,510728,308331,8243,2651,89,65
Uttar Pradesh,Jyotiba Phule Nagar,28.870498984771597,78.39009365482241,137,1840221,963449,876772,983110,600541,382569,1075440,750368,5952,5295,189,517,21,2439,451374,251669,352835,230640,161282,164763,69522,3021,1233732,520215,1753947,1227283,391275,215849,5814,2074,91,53
Uttar Pradesh,Kannauj,26.993988617886185,79.64437940379408,160,1656616,881776,774840,1017087,603596,413491,1375788,273967,1263,504,2033,606,65,2390,365770,237853,283674,263749,175582,107628,95072,7194,1170752,543034,1713786,1069916,361028,223535,2137,1730,87,61
Uttar Pradesh,Kanpur Dehat,26.43047641196011,79.98710083056478,163,1796184,963255,832929,1170243,692964,477279,1612968,176327,1300,478,819,155,103,4034,405256,235341,344866,341845,223529,157167,97740,5930,1406418,475166,1881584,1100820,415918,276272,3174,2056,86,65
Uttar Pradesh,Kaushambi,25.53587532051282,81.41811282051287,174,1599596,838485,761111,813424,507279,306145,1372381,220423,2225,522,687,545,3,2810,380620,184229,253910,180825,146757,89011,45341,5115,905188,670750,1575938,1034099,336401,210556,18540,1645,90,50
Uttar Pradesh,Kushinagar,26.892530675909864,83.92261542461007,189,3564544,1818055,1746489,1954820,1183722,771098,2928462,620244,5006,767,4619,383,133,4930,785099,836856,424892,367405,249265,170911,119625,11970,2180924,1550315,3731239,2236842,772777,500373,54552,3704,96,54
Uttar Pradesh,Lalitpur,24.58877161016945,78.60082330508473,167,1221592,641011,580581,641191,397586,243605,1163804,33724,1351,1034,69,20390,41,1179,301832,185575,202692,154118,61543,32237,34658,3535,674358,509536,1183894,793551,265080,159666,3295,1287,90,52
Uttar Pradesh,Lucknow,26.838233589251463,80.89706026871404,157,4589838,2394476,2195362,3127260,1742440,1384820,3537787,985070,20493,23883,3877,4975,504,13249,1061721,489898,554301,552171,428121,378742,639260,52132,3094625,1146880,4241505,2678289,1161686,685258,64605,7486,91,68
Uttar Pradesh,Mahoba,25.34529670138888,79.67863003472216,169,875958,466358,409600,488106,302283,185823,815142,57454,965,389,94,234,157,1523,246823,119002,141201,131165,60400,33810,37165,3926,526669,403649,930318,527067,201394,137393,10104,904,87,55
Uttar Pradesh,Mainpuri,27.17386862302482,79.03501851015807,148,1868529,993377,875152,1203885,712110,491775,1746649,100723,1729,475,8814,4161,38,5940,411258,234774,353287,319158,230731,144516,111696,12281,1406443,519493,1925936,1193660,402321,265638,6910,1998,88,64
Uttar Pradesh,Mathura,27.59390432801821,77.62153416856502,145,2547184,1367125,1180059,1507746,943346,564400,2310776,216933,3179,2872,883,2056,126,10359,585290,303291,420976,344961,233264,155937,103102,10262,1571793,691359,2263152,1600686,535738,327854,82906,3025,86,59
Uttar Pradesh,Mau,26.01082203791469,83.50582654028433,192,2205968,1114709,1091259,1363044,773082,589962,1769937,428555,2109,340,564,155,129,4179,451528,344570,410737,320743,256784,209493,150462,15771,1708560,659237,2367797,1402738,467343,323260,12627,2693,97,61
Uttar Pradesh,Meerut,29.02957625698323,77.80611005586593,138,3443689,1825743,1617946,2141488,1254520,886968,2183255,1185643,10582,24912,1855,18544,236,18662,803823,412280,495861,469403,359944,254337,275076,36096,2302997,990312,3293309,2165117,780475,451827,46270,4953,88,62
Uttar Pradesh,Mirzapur,25.10207959183675,82.60126628571429,199,2496970,1312302,1184668,1428683,865837,562846,2292534,195765,2373,1133,341,701,27,4096,543115,361642,421577,340261,232189,177109,140668,17680,1691126,868542,2559668,1590528,552177,346773,7492,2875,90,57
Uttar Pradesh,Moradabad,28.851770406189537,78.73580193423597,135,4772006,2503186,2268820,2263848,1357435,906413,2488265,2248392,13157,7555,1260,2426,382,10569,1047916,635957,725118,492338,296210,186311,186489,23372,2545795,2097292,4643087,3168270,988486,525574,89676,5452,90,47
Uttar Pradesh,Muzaffarnagar,29.470507977736563,77.64017847866423,133,4143512,2193434,1950078,2417339,1448528,968811,2382914,1711453,6495,18601,1516,16345,60,6128,969850,826387,780470,531913,281747,148770,98691,5608,2673586,1431537,4105123,2671757,911621,544283,15851,4871,88,58
Uttar Pradesh,Pilibhit,28.52024175035868,79.90103974175037,151,2031007,1072002,959005,1061095,654290,406805,1449007,489686,3510,84787,360,138,45,3474,461390,294135,281158,240057,117838,77602,66129,9713,1086632,977839,2064471,1320476,449673,256276,4582,2125,89,52
Uttar Pradesh,Pratapgarh,25.864842731707316,81.93530048780492,131,867848,437744,430104,401515,250122,151393,827293,25597,358,72,32,14077,27,392,234082,142397,111276,70969,35206,21854,19109,2137,402948,488621,891569,545987,204801,115608,1452,2829,98,46
Uttar Pradesh,Pratapgarh,25.864842731707316,81.93530048780492,173,3209141,1606085,1603056,1931559,1121381,810178,2731351,452394,3920,1451,7795,746,43,11441,752786,427626,558350,456752,332742,238011,197846,20047,2231374,1059636,3291010,2002569,703727,492097,10748,3639,99,60
Uttar Pradesh,Rae Bareli,26.253902840059787,81.22260463378181,158,3405559,1752542,1653017,1965843,1165965,799878,2975998,413243,3634,2424,722,397,602,8539,778418,540661,538301,477689,270775,182823,153041,15662,2178952,1286726,3465678,2116007,776583,506583,6386,3812,94,57
Uttar Pradesh,Rampur,28.83244727272725,79.10977333333337,136,2335819,1223889,1111930,1043666,630408,413258,1073890,1181337,9201,65316,384,1307,63,4321,539992,278477,374898,171242,85117,51703,43839,3169,1008445,1235413,2243858,1576123,491164,258913,9619,2545,90,44
Uttar Pradesh,Saharanpur,30.03381165217392,77.59905147826095,132,3466382,1834106,1632276,2077108,1220114,856994,1966892,1454052,6523,18627,1937,10208,135,8008,889238,474060,600668,431491,256510,163463,154153,10083,2090428,1279517,3369945,2228689,769736,433862,34095,4029,88,59
Uttar Pradesh,Sant Kabir Nagar,26.791596516393444,83.0387764344262,186,1715183,869656,845527,954949,567098,387851,1300586,404410,1766,447,4393,95,35,3451,352151,341757,290532,205875,129442,86528,63506,8882,1126522,683053,1809575,1108368,352395,250502,3918,1850,97,55
Uttar Pradesh,Shahjahanpur,27.991389350649328,79.8302275324675,152,3006538,1606403,1400135,1490930,915142,575788,2412595,527581,4630,51090,2312,301,84,7945,655003,451571,476064,315873,158430,96308,87355,8885,1594486,1324615,2919101,1961237,652237,368743,24321,3441,87,49
Uttar Pradesh,Sitapur,27.501995963091108,80.85288881199547,154,4483992,2375264,2108728,2283733,1397702,886031,3555450,893725,6579,11611,2663,1410,79,12475,938902,714304,656401,482220,221898,136383,127750,8775,2347731,2141696,4489427,2862383,1000987,588318,32304,4535,88,50
Uttar Pradesh,Sonbhadra,24.46693268858798,83.06816324951639,200,1862559,971344,891215,985708,601988,383720,1738769,103567,3963,1649,1747,487,1907,10470,428088,306218,297226,212565,120822,82614,63846,9357,1092648,745126,1837774,1203938,418914,237866,1841,2337,91,52
Uttar Pradesh,Sultanpur,26.2846386419753,82.05710456790123,179,3797117,1914586,1882531,2239902,1300248,939654,3119590,650261,4453,1629,9989,426,336,10433,889628,460210,637015,526973,306046,188848,176414,15277,2310783,1118891,3429674,2376875,828222,580164,11856,4190,98,58
Uttar Pradesh,Unnao,26.63163990895297,80.636773292868,156,3108367,1630087,1478280,1773584,1053063,720521,2732016,363453,3574,1204,920,240,31,6929,717356,501457,512965,415378,240024,136688,101934,7173,1915619,1130103,3045722,1893706,706851,453462,54348,3620,90,57
Uttar Pradesh,Varanasi,25.36057088888889,82.82529666666672,197,3676841,1921857,1754984,2403903,1389116,1014787,3107681,546987,7696,3309,1146,1898,298,7826,755064,467782,608174,557052,447926,351391,281652,34841,2748818,906367,3655185,2260457,856070,531549,28765,5059,91,65
Uttaranchal,Almora,29.683532133676103,79.50165064267351,64,622506,291081,331425,436497,231604,204893,611250,7752,1895,256,201,31,6,1115,281138,90864,120029,115810,76148,53026,37742,2263,495882,109556,605438,351595,141238,128994,679,742,113,70
Uttaranchal,Bageshwar,29.98703393393397,79.83954354354357,63,259898,124326,135572,179483,97546,81937,257509,1440,397,46,102,7,16,381,99911,38113,47788,50340,31224,20785,10900,675,199825,49539,249364,147488,60569,51672,169,281,109,69
Uttaranchal,Chamoli,30.58338611464965,79.56281095541402,57,391605,193991,197614,280556,155395,125161,385818,4395,428,323,190,11,23,417,186340,47447,68435,67519,47703,32557,27168,2367,293196,61950,355146,229715,93182,67873,835,467,101,71
Uttaranchal,Champawat,29.29142393939393,80.07720212121217,65,259648,131125,128523,177726,102015,75711,249563,8693,870,336,24,28,6,128,98041,36127,48093,45766,23610,18360,15110,1317,188383,62429,250812,156916,60722,41913,97,309,98,68
Uttaranchal,Pithoragarh,30.14720631868129,80.34229230769236,62,483439,239306,244133,345550,189623,155927,475105,6015,1401,260,185,13,30,430,209943,63591,87585,90983,56591,42086,28375,2237,371448,88036,459484,273494,116749,92517,679,631,102,71
Uttaranchal,Tehri Garhwal,30.463700918635173,78.48783792650917,59,618931,297986,320945,407994,227406,180588,609835,7374,656,290,32,91,109,544,254236,72163,103462,95417,74008,58434,30704,2073,436261,133013,569274,368324,139371,109998,1238,743,107,65
Uttaranchal,Udham Singh Nagar,29.02779577677222,79.45629004524895,67,1648902,858783,790119,1037839,598525,439314,1104452,372267,6064,162768,505,738,159,1949,414659,179602,302653,232381,169274,113661,111062,11786,1120419,438598,1559017,1042614,392370,212223,1695,1805,92,62
Uttaranchal,Uttarkashi,30.968958552036234,78.56880615384617,56,330086,168597,161489,215126,128237,86889,324859,3554,353,167,563,74,105,411,121209,43442,46625,47640,30901,24989,18882,981,213460,83896,297356,202426,75997,51245,418,356,95,65
West Bengal,Bankura,23.081280892857155,87.12640053571437,339,3596674,1838095,1758579,2232992,1299337,933655,3033581,290450,3865,386,260,2904,260694,4534,991400,450029,545200,686924,261478,143882,133465,20379,2241357,1417787,3659144,1942335,1014764,637834,1741,3959,95,62
West Bengal,Barddhaman,23.444453888888884,87.8150581111111,335,7717563,3966889,3750674,5247208,2918040,2329168,6008472,1599764,21220,16675,1602,1674,44968,23188,2227236,800473,1437198,1605634,698251,405935,439823,62616,5449930,2196886,7646816,4149420,2265543,1292913,9687,13547,94,67
West Bengal,Birbhum,24.06389342723,87.65153089201888,334,3502404,1790920,1711484,2158447,1201481,956966,2181515,1298054,10906,582,258,1152,6051,3886,965609,417769,661190,622372,245201,122865,115743,15205,2200345,1346802,3547147,2008655,952059,539463,2227,3911,95,61
West Bengal,Dakshin Dinajpur,25.342094363021435,88.69821679819614,331,1676276,857199,819077,1083685,596474,487211,1232850,412788,24794,276,148,323,2786,2311,461026,247675,323965,327064,135556,63286,52345,5190,1155081,534394,1689475,937283,465982,271423,1588,2039,95,64
West Bengal,Darjiling,26.839619571045585,88.33145067024122,327,1846823,937259,909564,1315585,717673,597912,1366681,105086,141848,2032,209240,1840,15523,4573,518959,183479,344865,402415,176129,113905,110193,12851,1343837,415353,1759190,1031221,523288,289979,2335,3146,97,71
West Bengal,Haora,22.401674174428507,87.99421176968654,341,4850029,2500819,2349210,3605206,1942824,1662382,3535844,1270641,8666,4380,1258,9699,1265,18276,1352697,516323,1059842,1084155,446743,284481,304594,37027,3733165,926661,4659826,2587164,1423304,833104,6457,9414,93,74
West Bengal,Hugli,22.87929264705881,88.00010264705891,338,5519145,2814653,2704492,4078388,2211777,1866611,4574569,870204,7300,2662,1730,2160,49050,11470,1640038,676265,1172797,1174912,515807,333658,380060,44252,4297751,1180806,5478557,2766489,1688206,1060821,3629,9450,96,73
West Bengal,Jalpaiguri,26.62642031250004,89.04154375000003,328,3872846,1983064,1889782,2498780,1396622,1102158,3156781,445817,186279,2994,50676,1461,23816,5022,1117804,455854,765613,814395,292056,150360,129393,18916,2626587,1203423,3830010,2259507,1035449,575667,2223,5160,95,64
West Bengal,Kolkata,22.550581481481483,88.3527648148148,342,4496694,2356766,2139928,3588137,1926915,1661222,3440290,926414,39758,13849,4771,21178,1452,48982,1308106,255171,597841,820902,555529,425245,691804,89701,3436193,410988,3847181,2025389,1433314,1014769,23222,16375,90,79
West Bengal,Maldah,25.08026802575105,88.17191684549356,332,3988845,2051541,1937304,2086432,1152019,934413,1914352,2045151,13209,747,359,639,7929,6459,958996,478902,629137,595551,238078,109719,92207,18330,2161924,1960034,4121958,2511004,955283,520122,2436,4191,94,52
West Bengal,Murshidabad,24.25950655391121,88.16816860465121,333,7103807,3627564,3476243,4055834,2177187,1878647,2359061,4707573,18102,766,348,3037,7429,7491,1851965,837828,1428661,1210859,443254,230242,170051,25975,4346870,3031841,7378711,4390564,1717594,991413,4236,8088,95,57
West Bengal,Nadia,23.56410971055088,88.58293034547152,336,5167600,2653768,2513832,3480555,1878866,1601689,3728482,1382682,33835,849,514,281,16893,4064,1549771,605490,1093403,1052487,412193,236828,209562,25491,3635454,1570127,5205581,2745828,1484986,934417,2369,7048,94,67
West Bengal,Puruliya,23.254192328767108,86.3968532876713,340,2930115,1496996,1433119,1624905,1002058,622847,2373120,227249,8646,622,209,3052,309029,8188,752652,299355,480046,528068,177459,91807,77621,10072,1664428,1272799,2937227,1678057,764776,484166,3116,3309,95,55
West Bengal,Uttar Dinajpur,26.044619165196977,88.23595232216337,330,3007134,1551066,1456068,1489667,853495,636172,1482943,1501170,16702,477,432,1324,1622,2464,778250,402590,488047,422777,163106,73395,59457,12723,1622095,1431264,3053359,1916033,704859,385155,1087,3214,93,49
